Id,Label,timeset,v_name,v_id,v_freq,v_fastgreedy,indegree,outdegree,Degree,componentnumber,strongcompnum,pageranks,modularity_class,weighted indegree,weighted outdegree,Weighted Degree
n0,practice,,practice,practice,89,1,11,1,12,0,20,0.001221,0,0,0,0
n1,inquiry,,inquiry,inquiry,418,1,68,1,69,0,20,0.050556,0,0,0,0
n2,think,,think,think,72,16,8,1,9,0,20,0.00107,4,12,3,15
n3,pedagogy,,pedagogy,pedagogy,37,15,6,1,7,0,20,0.000519,0,4,2,6
n4,digital,,digital,digital,14,6,2,1,3,0,20,0.000136,3,0,4,4
n5,age,,age,age,14,1,2,7,9,0,20,0.000144,0,0,0,0
n6,opportunity,,opportunity,opportunity,30,1,5,1,6,0,20,0.00033,0,0,0,0
n7,reconsider,,reconsider,reconsider,2,1,0,1,1,0,21,0.000088,0,0,0,0
n8,basic,,basic,basic,20,1,4,1,5,0,20,0.000305,0,0,0,0
n9,model,,model,model,139,14,20,1,21,0,20,0.043534,4,0,0,0
n10,teacher,,teacher,teacher,179,4,30,1,31,0,20,0.004686,1,33,0,33
n11,learn,,learn,learn,306,1,45,1,46,0,20,0.055339,0,0,0,0
n12,one,,one,one,35,15,5,1,6,0,20,0.000492,1,4,2,6
n13,start,,start,start,23,2,6,1,7,0,20,0.00069,0,1,5,6
n14,point,,point,point,32,2,8,16,24,0,20,0.001542,0,11,2,13
n15,interest,,interest,interest,56,14,11,2,13,0,20,0.001054,1,0,0,0
n16,learner,,learner,learner,48,14,10,1,11,0,20,0.001274,6,0,0,0
n17,category_classify,,category_classify,category_classify,28,14,7,1,8,0,20,0.000452,3,0,0,0
n18,dewey,,dewey,dewey,20,1,4,1,5,0,20,0.000675,0,0,0,0
n19,conversation,,conversation,conversation,10,16,0,1,1,0,22,0.000088,9,0,2,2
n20,communicate,,communicate,communicate,28,16,5,2,7,0,20,0.00148,0,8,4,12
n21,find,,find,find,30,16,6,2,8,0,20,0.001444,0,6,0,6
n22,thing,,thing,thing,20,7,5,1,6,0,20,0.001187,0,5,3,8
n23,make,,make,make,86,5,11,1,12,0,20,0.010423,3,15,8,23
n24,construct,,construct,construct,49,13,7,2,9,0,20,0.000732,1,3,8,11
n25,art,,art,art,4,6,1,2,3,0,20,0.000247,3,1,1,2
n26,express,,express,express,22,16,8,1,9,0,20,0.000595,0,1,2,3
n27,call,,call,call,4,8,0,2,2,0,23,0.000088,5,0,1,1
n28,natural,,natural,natural,26,8,5,1,6,0,20,0.001109,5,4,3,7
n29,resource,,resource,resource,12,11,1,6,7,0,20,0.000233,0,0,2,2
n30,uninvested,,uninvested,uninvested,2,11,1,1,2,0,20,0.000121,0,1,1,2
n31,capital,,capital,capital,2,11,1,1,2,0,20,0.000191,0,1,1,2
n32,upon,,upon,upon,14,11,3,7,10,0,20,0.000568,1,4,1,5
n33,depend,,depend,depend,4,11,1,2,3,0,20,0.000157,1,1,0,1
n34,active,,active,active,34,3,5,1,6,0,20,0.000421,15,2,4,6
n35,grow,,grow,grow,4,3,1,2,3,0,20,0.000136,14,1,1,2
n36,child,,child,child,364,3,74,1,75,0,20,0.014024,2,106,12,118
n37,dewey1956pp4748,,dewey1956pp4748,dewey1956pp4748,2,1,0,1,1,0,24,0.000088,0,0,0,0
n38,state,,state,state,32,17,7,1,8,0,20,0.001519,0,10,0,10
n39,similar,,similar,similar,24,6,2,12,14,0,20,0.00066,4,4,4,8
n40,idea,,idea,idea,88,14,14,3,17,0,20,0.001372,2,0,0,0
n41,process,,process,process,170,16,18,1,19,0,20,0.002481,3,13,8,21
n42,form,,form,form,42,13,9,21,30,0,20,0.002447,0,8,4,12
n43,stage,,stage,stage,28,5,6,14,20,0,20,0.000422,1,2,5,7
n44,reflective,,reflective,reflective,8,8,3,1,4,0,20,0.000219,0,0,2,2
n45,action,,action,action,22,8,3,1,4,0,20,0.000362,0,2,2,4
n46,definition,,definition,definition,9,1,2,1,3,0,20,0.000708,0,0,0,0
n47,latter,,latter,latter,4,11,0,2,2,0,28,0.000088,5,0,1,1
n48,use,,use,use,150,14,32,2,34,0,20,0.043389,6,0,0,0
n49,situation,,situation,situation,23,4,4,1,5,0,20,0.000627,0,5,2,7
n50,provide,,provide,provide,44,15,4,3,7,0,20,0.000343,4,1,2,3
n51,descriptive,,descriptive,descriptive,4,13,1,2,3,0,20,0.000228,4,1,2,3
n52,account,,account,account,8,13,1,4,5,0,20,0.000185,4,1,2,3
n53,survival,,survival,survival,2,13,1,1,2,0,20,0.000127,4,1,0,1
n54,world,,world,world,72,8,10,1,11,0,20,0.034607,0,12,10,22
n55,control,,control,control,6,12,1,1,2,0,29,0.000163,1,1,2,3
n56,instruct_guide,,instruct_guide,instruct_guide,18,12,4,1,5,0,20,0.000689,1,4,2,6
n57,transformation,,transformation,transformation,6,12,1,3,4,0,20,0.000673,1,2,1,3
n58,indetermine,,indetermine,indetermine,8,4,2,1,3,0,20,0.000303,0,0,4,4
n59,determine,,determine,determine,4,3,0,2,2,0,30,0.000088,0,0,2,2
n60,constitute,,constitute,constitute,8,3,4,4,8,0,20,0.000365,0,4,1,5
n61,distinction,,distinction,distinction,6,9,3,3,6,0,20,0.000256,1,0,0,0
n62,relation,,relation,relation,24,8,7,2,9,0,20,0.000655,5,5,2,7
n63,convert,,convert,convert,2,1,0,1,1,0,31,0.000088,0,0,0,0
n64,element,,element,element,12,1,3,1,4,0,20,0.000294,0,0,0,0
n65,original,,original,original,6,3,2,3,5,0,20,0.000177,0,1,1,2
n66,unified,,unified,unified,4,10,1,1,2,0,20,0.000156,1,1,2,3
n67,whole,,whole,whole,6,10,1,3,4,0,20,0.00022,1,2,2,4
n68,inspire,,inspire,inspire,6,13,0,3,3,0,32,0.000088,3,0,1,1
n69,source,,source,source,6,1,2,3,5,0,20,0.000156,0,0,0,0
n70,fundamental,,fundamental,fundamental,6,1,2,3,5,0,20,0.000201,0,0,0,0
n71,begin,,begin,begin,18,14,2,9,11,0,20,0.000245,1,0,0,0
n72,spiral,,spiral,spiral,2,1,0,1,1,0,33,0.000088,0,0,0,0
n73,path,,path,path,18,1,4,9,13,0,20,0.000552,0,0,0,0
n74,envisioned,,envisioned,envisioned,2,5,0,1,1,0,34,0.000088,0,0,1,1
n75,ask,,ask,ask,52,5,12,1,13,0,20,0.002091,0,7,13,20
n76,question,,question,question,181,5,29,1,30,0,20,0.010591,0,36,6,42
n77,investigate,,investigate,investigate,72,11,7,4,11,0,20,0.001072,3,7,4,11
n78,solution,,solution,solution,22,1,5,1,6,0,20,0.000378,0,0,0,0
n79,create,,create,create,30,18,2,3,5,0,13,0.000231,0,0,0,0
n80,discuss,,discuss,discuss,54,10,7,1,8,0,20,0.000725,0,3,3,6
n81,discover,,discover,discover,27,6,4,3,7,0,20,0.000341,0,4,2,6
n82,experience,,experience,experience,153,7,25,2,27,0,20,0.012172,1,25,6,31
n83,reflect,,reflect,reflect,50,10,9,2,11,0,20,0.002028,0,11,2,13
n84,new,,new,new,86,13,20,1,21,0,20,0.001512,3,15,8,23
n85,knowledge,,knowledge,knowledge,124,13,17,1,18,0,20,0.004107,3,33,0,33
n86,follow,,follow,follow,19,1,3,10,13,0,20,0.00024,0,0,0,0
n87,brucebishop2002,,brucebishop2002,brucebishop2002,2,4,0,1,1,0,35,0.000088,2,0,1,1
n88,phase,,phase,phase,66,4,21,1,22,0,20,0.001453,2,12,3,15
n89,leadership,,leadership,leadership,30,3,4,1,5,0,20,0.000653,2,1,3,4
n90,next,,next,next,12,1,3,1,4,0,20,0.000358,0,0,0,0
n91,authentic,,authentic,authentic,14,7,2,1,3,0,20,0.005334,1,3,0,3
n92,teachable,,teachable,teachable,2,5,0,1,1,0,37,0.000088,0,0,1,1
n93,moment,,moment,moment,4,5,1,2,3,0,36,0.000163,0,1,1,2
n94,explore,,explore,explore,125,3,26,1,27,0,20,0.016317,2,31,0,31
n95,turn,,turn,turn,4,14,0,2,2,0,38,0.000088,1,0,0,0
n96,brucedavidson1996,,brucedavidson1996,brucedavidson1996,2,10,0,1,1,0,39,0.000088,0,0,1,1
n97,solve,,solve,solve,36,6,3,1,4,0,6,0.004824,0,13,5,18
n98,problem,,problem,problem,81,6,19,1,20,0,6,0.005449,0,16,11,27
n99,reformulating,,reformulating,reformulating,2,6,0,1,1,0,40,0.000088,0,0,1,1
n100,posing,,posing,posing,4,13,0,2,2,0,43,0.000088,3,0,1,1
n101,close,,close,close,4,6,0,2,2,0,46,0.000088,1,0,1,1
n102,tied,,tied,tied,2,6,1,1,2,0,45,0.000125,1,1,1,2
n103,dialogue,,dialogue,dialogue,11,6,2,1,3,0,44,0.000269,1,2,2,4
n104,others,,others,others,30,6,8,15,23,0,20,0.000858,1,7,3,10
n105,cycle,,cycle,cycle,48,1,3,1,4,0,20,0.047374,0,0,0,0
n106,present,,present,present,20,1,6,10,16,0,20,0.000557,0,0,0,0
n107,aspect,,aspect,aspect,24,1,5,1,6,0,20,0.00034,0,0,0,0
n108,need,,need,need,32,3,9,16,25,0,20,0.000904,14,3,6,9
n109,support,,support,support,61,3,12,1,13,0,20,0.001424,2,4,4,8
n110,success,,success,success,10,3,3,1,4,0,20,0.000182,15,1,2,3
n111,environment,,environment,environment,36,3,3,1,4,0,20,0.000334,2,0,3,3
n112,serve,,serve,serve,8,12,0,1,1,0,48,0.000088,4,0,2,2
n113,boundary,,boundary,boundary,2,13,0,1,1,0,49,0.000088,6,0,1,1
n114,object,,object,object,42,13,8,4,12,0,20,0.000597,6,3,4,7
n115,stargriesmer1989,,stargriesmer1989,stargriesmer1989,2,12,0,1,1,0,50,0.000088,0,0,1,1
n116,allow,,allow,allow,32,12,5,1,6,0,20,0.000542,0,4,6,10
n117,us,,us,us,13,1,2,1,3,0,20,0.000228,0,0,0,0
n118,relate,,relate,relate,30,13,2,1,3,0,20,0.001713,4,4,2,6
n119,theory,,theory,theory,37,14,5,18,23,0,20,0.00973,2,0,0,0
n120,ordinary,,ordinary,ordinary,2,14,1,1,2,0,20,0.000547,2,0,0,0
n121,look,,look,look,16,7,3,1,4,0,20,0.000307,0,4,3,7
n122,across,,across,across,16,6,6,1,7,0,20,0.000497,2,4,2,6
n123,modes,,modes,modes,4,16,0,2,2,0,51,0.000088,3,0,1,1
n124,context,,context,context,42,4,8,2,10,0,20,0.011655,0,13,0,13
n125,inform,,inform,inform,8,1,2,4,6,0,20,0.000205,0,0,0,0
n126,guide,,guide,guide,82,1,16,1,17,0,20,0.001682,0,0,0,0
n127,education,,education,education,86,4,11,2,13,0,20,0.023535,7,17,3,20
n128,important,,important,important,36,2,11,2,13,0,20,0.000897,4,7,4,11
n129,note,,note,note,6,18,1,3,4,0,23,0.000127,1,0,0,0
n130,merely,,merely,merely,4,18,1,2,3,0,22,0.000124,1,0,0,0
n131,suggestive,,suggestive,suggestive,2,18,1,1,2,0,21,0.00014,1,0,0,0
n132,neither,,neither,neither,4,18,1,2,3,0,20,0.000207,1,0,0,0
n133,sole,,sole,sole,4,18,1,2,3,0,19,0.000176,1,0,0,0
n134,complete,,complete,complete,4,18,2,2,4,0,18,0.000262,1,0,0,0
n135,rigid,,rigid,rigid,2,18,1,1,2,0,17,0.000199,1,0,0,0
n136,characterization,,characterization,characterization,2,18,1,1,2,0,16,0.000257,1,0,0,0
n137,actual,,actual,actual,10,19,3,5,8,0,20,0.000238,1,2,1,3
n138,rarely,,rarely,rarely,2,7,0,1,1,0,53,0.000088,1,0,1,1
n139,proceeds,,proceeds,proceeds,4,7,1,2,3,0,52,0.000163,1,1,1,2
n140,simple,,simple,simple,26,5,5,1,6,0,20,0.000497,3,3,3,6
n141,linear,,linear,linear,8,20,2,4,6,0,20,0.000259,0,1,2,3
n142,fashion,,fashion,fashion,2,5,1,1,2,0,20,0.000143,1,0,1,1
n143,five,,five,five,10,5,1,5,6,0,20,0.000209,1,1,2,3
n144,dimension,,dimension,dimension,36,1,4,1,5,0,20,0.000466,0,0,0,0
n145,overlap,,overlap,overlap,2,8,0,1,1,0,54,0.000088,7,0,1,1
n146,every,,every,every,14,8,3,7,10,0,20,0.000261,7,2,2,4
n147,give,,give,give,24,3,8,1,9,0,20,0.000509,2,2,3,5
n148,embed,,embed,embed,8,6,1,4,5,0,56,0.000107,5,1,3,4
n149,fact,,fact,fact,16,13,5,8,13,0,20,0.000732,1,0,4,4
n150,nature,,nature,nature,14,1,5,2,7,0,20,0.000423,0,0,0,0
n151,mutual,,mutual,mutual,4,20,0,2,2,0,57,0.000088,1,0,1,1
n152,reinforce,,reinforce,reinforce,8,20,3,4,7,0,20,0.000221,1,2,2,4
n153,interrelated,,interrelated,interrelated,2,20,1,1,2,0,20,0.000135,1,1,1,2
n154,despite,,despite,despite,4,20,2,2,4,0,20,0.000258,1,1,0,1
n155,complexity,,complexity,complexity,6,1,3,3,6,0,20,0.000309,0,0,0,0
n156,highlights,,highlights,highlights,4,1,0,2,2,0,59,0.000088,0,0,0,0
n157,otherwise,,otherwise,otherwise,2,16,0,1,1,0,61,0.000088,3,0,1,1
n158,opaque,,opaque,opaque,2,16,1,1,2,0,60,0.000163,3,1,1,2
n159,reminds,,reminds,reminds,8,4,2,2,4,0,20,0.000153,1,0,2,2
n160,develop,,develop,develop,119,2,22,1,23,0,20,0.003125,1,14,0,14
n161,arise,,arise,arise,14,3,3,7,10,0,20,0.000466,14,3,1,4
n162,meaning,,meaning,meaning,42,4,9,1,10,0,20,0.000764,0,6,3,9
n163,genuine,,genuine,genuine,4,14,2,1,3,0,20,0.000161,1,0,0,0
n164,reallife,,reallife,reallife,4,7,0,1,1,0,62,0.000088,1,0,2,2
n165,challenge,,challenge,challenge,24,5,5,1,6,0,20,0.000301,0,1,2,3
n166,refer,,refer,refer,14,13,3,7,10,0,20,0.000291,3,1,2,3
n167,part,,part,part,18,1,3,1,4,0,20,0.000367,0,0,0,0
n168,include,,include,include,50,6,12,1,13,0,20,0.001534,3,9,0,9
n169,individual,,individual,individual,12,8,3,1,4,0,20,0.00054,5,4,2,6
n170,participate,,participate,participate,42,14,5,1,6,0,20,0.000529,4,0,0,0
n171,community,,community,community,22,18,3,1,4,0,25,0.001072,4,0,0,0
n172,something,,something,something,8,17,2,4,6,0,20,0.000192,1,1,3,4
n173,delivered,,delivered,delivered,4,17,1,2,3,0,20,0.000129,1,1,1,2
n174,outside,,outside,outside,2,17,1,1,2,0,20,0.000143,1,1,0,1
n175,example,,example,example,12,3,2,6,8,0,65,0.0002,0,2,3,5
n176,come,,come,come,14,3,4,7,11,0,20,0.000326,0,3,2,5
n177,early,,early,early,81,4,16,1,17,0,20,0.003126,4,6,21,27
n178,study,,study,study,58,4,16,1,17,0,20,0.001746,3,9,3,12
n179,computer,,computer,computer,12,12,1,6,7,0,20,0.000143,5,1,3,4
n180,researcher,,researcher,researcher,8,18,2,4,6,0,26,0.000183,1,0,0,0
n181,found,,found,found,10,3,2,5,7,0,20,0.000201,3,1,3,4
n182,student,,student,student,174,12,31,1,32,0,20,0.003165,0,22,0,22
n183,become,,become,become,22,14,2,1,3,0,20,0.000183,2,0,0,0
n184,engage,,engage,engage,84,3,15,1,16,0,20,0.001353,15,11,4,15
n185,bug,,bug,bug,4,12,1,2,3,0,20,0.000131,5,0,1,1
n186,software,,software,software,4,14,1,2,3,0,20,0.000113,7,0,0,0
n187,behavior,,behavior,behavior,8,13,1,4,5,0,20,0.000202,6,0,2,2
n188,deep,,deep,deep,9,6,2,5,7,0,20,0.000144,5,1,2,3
n189,programming,,programming,programming,2,18,0,1,1,0,27,0.000088,1,0,0,0
n190,enormous,,enormous,enormous,2,18,1,1,2,0,14,0.000124,1,0,0,0
n191,different,,different,different,36,6,8,1,9,0,20,0.001038,2,4,2,6
n192,answer,,answer,answer,20,5,4,1,5,0,20,0.000973,0,1,4,5
n193,someone,,someone,someone,2,5,0,1,1,0,68,0.000088,0,0,1,1
n194,elses,,elses,elses,2,5,1,1,2,0,67,0.000163,0,1,1,2
n195,formulate,,formulate,formulate,16,13,1,1,2,0,20,0.00017,4,0,2,2
n196,oldsschwartzwillie1980p40,,oldsschwartzwillie1980p40,oldsschwartzwillie1980p40,2,2,0,1,1,0,69,0.000088,4,0,1,1
n197,caution,,caution,caution,4,4,1,2,3,0,70,0.000163,1,1,1,2
n198,always,,always,always,8,12,1,4,5,0,71,0.000194,1,1,2,3
n199,well,,well,well,24,6,5,12,17,0,20,0.000542,2,4,6,10
n200,articulate,,articulate,articulate,12,5,4,6,10,0,20,0.000225,1,1,3,4
n201,elspethhuxley1959,,elspethhuxley1959,elspethhuxley1959,2,17,1,1,2,0,20,0.000136,0,0,1,1
n202,best,,best,best,10,6,4,5,9,0,20,0.000311,6,3,2,5
n203,way,,way,way,42,16,12,3,15,0,20,0.00103,0,5,4,9
n204,fire,,fire,fire,2,5,0,1,1,0,72,0.000088,0,0,1,1
n205,like,,like,like,14,9,1,1,2,0,20,0.001332,2,0,0,0
n206,firing,,firing,firing,2,11,0,1,1,0,73,0.000088,2,0,1,1
n207,gun,,gun,gun,4,11,2,2,4,0,20,0.000261,2,2,2,4
n208,bang,,bang,bang,2,11,1,1,2,0,20,0.000199,2,1,1,2
n209,goes,,goes,goes,2,11,1,1,2,0,20,0.000257,2,1,1,2
n210,everything,,everything,everything,2,11,1,1,2,0,20,0.000306,2,1,0,1
n211,take,,take,take,38,12,10,1,11,0,20,0.001275,8,4,5,9
n212,flight,,flight,flight,2,7,0,1,1,0,79,0.000088,2,0,1,1
n213,runs,,runs,runs,2,7,1,1,2,0,78,0.000163,2,1,1,2
n214,shelter,,shelter,shelter,2,7,1,1,2,0,77,0.000226,2,1,1,2
n215,sit,,sit,sit,2,7,1,1,2,0,76,0.00028,2,1,1,2
n216,quite,,quite,quite,4,7,1,2,3,0,75,0.000326,2,1,2,3
n217,still,,still,still,8,7,2,4,6,0,20,0.000242,8,2,2,4
n218,play,,play,play,40,3,7,1,8,0,20,0.000643,4,4,2,6
n219,little,,little,little,4,9,1,2,3,0,20,0.000282,2,0,0,0
n220,will,,will,will,24,13,5,1,6,0,20,0.000481,6,3,2,5
n221,peck,,peck,peck,2,4,1,1,2,0,20,0.000127,0,0,1,1
n222,round,,round,round,2,4,1,1,2,0,20,0.000196,0,1,1,2
n223,feet,,feet,feet,2,4,1,1,2,0,20,0.000255,0,1,1,2
n224,venture,,venture,venture,2,15,0,1,1,0,82,0.000088,5,0,1,1
n225,forth,,forth,forth,2,15,1,1,2,0,81,0.000163,5,1,1,2
n226,thickets,,thickets,thickets,2,15,1,1,2,0,80,0.000226,5,1,1,2
n227,intent,,intent,intent,10,15,3,2,5,0,20,0.00087,5,5,2,7
n228,creep,,creep,creep,2,7,0,1,1,0,85,0.000088,3,0,1,1
n229,sun,,sun,sun,2,7,1,1,2,0,84,0.000163,3,1,1,2
n230,stone,,stone,stone,2,7,1,1,2,0,83,0.000226,3,1,1,2
n231,patient,,patient,patient,4,7,2,2,4,0,20,0.000322,3,2,0,2
n232,see,,see,see,28,7,4,1,5,0,20,0.001233,0,5,3,8
n233,understand,,understand,understand,125,1,23,1,24,0,20,0.001453,0,0,0,0
n234,great,,great,great,10,2,1,5,6,0,20,0.000241,2,1,3,4
n235,deal,,deal,deal,8,2,1,4,5,0,20,0.000129,2,1,2,3
n236,man,,man,man,2,11,1,1,2,0,20,0.000115,2,0,1,1
n237,p272,,p272,p272,2,11,1,1,2,0,20,0.000199,2,1,1,2
n238,variety,,variety,variety,4,7,1,1,2,0,20,0.000138,1,1,2,3
n239,possible,,possible,possible,14,16,4,7,11,0,20,0.000406,8,2,2,4
n240,many,,many,many,17,16,7,9,16,0,20,0.000726,8,5,4,9
n241,suggests,,suggests,suggests,12,5,2,6,8,0,20,0.00049,1,3,1,4
n242,require,,require,require,4,2,1,2,3,0,20,0.000198,5,1,2,3
n243,diverse,,diverse,diverse,4,2,1,2,3,0,20,0.000172,5,1,0,1
n244,material,,material,material,36,8,6,1,7,0,20,0.010042,0,5,5,10
n245,interaction,,interaction,interaction,52,1,12,1,13,0,20,0.001084,0,0,0,0
n246,moral,,moral,moral,2,6,1,1,2,0,20,0.000136,1,1,0,1
n247,physical,,physical,physical,16,6,3,1,4,0,20,0.000272,8,1,2,3
n248,emotional,,emotional,emotional,4,6,1,2,3,0,20,0.000319,8,2,2,4
n249,aesthetic,,aesthetic,aesthetic,4,6,2,2,4,0,20,0.000378,8,2,0,2
n250,practical,,practical,practical,4,1,2,2,4,0,20,0.000323,0,0,0,0
n251,inherent,,inherent,inherent,6,1,0,3,3,0,87,0.000088,0,0,0,0
n252,enhance,,enhance,enhance,12,10,4,6,10,0,20,0.000248,2,2,2,4
n253,addons,,addons,addons,2,10,1,1,2,0,20,0.000123,2,1,0,1
n254,gather,,gather,gather,16,13,2,1,3,0,20,0.000156,5,1,3,4
n255,information,,information,information,21,13,4,10,14,0,20,0.000366,5,5,5,10
n256,craft,,craft,craft,2,5,0,1,1,0,88,0.000088,7,0,1,1
n257,experiment,,experiment,experiment,24,5,4,12,16,0,20,0.000486,7,5,4,9
n258,observe,,observe,observe,32,11,7,1,8,0,20,0.001023,5,6,0,6
n259,interview,,interview,interview,4,8,1,2,3,0,89,0.000123,5,1,0,1
n260,recast,,recast,recast,2,5,0,1,1,0,90,0.000088,0,0,1,1
n261,refine,,refine,refine,12,18,2,1,3,0,10,0.000323,0,0,0,0
n262,line,,line,line,4,1,1,2,3,0,20,0.000186,0,0,0,0
n263,query,,query,query,6,4,2,1,3,0,20,0.000242,1,2,2,4
n264,plunge,,plunge,plunge,2,13,0,1,1,0,91,0.000088,3,0,1,1
n265,anticipate,,anticipate,anticipate,2,13,0,1,1,0,92,0.000088,5,0,1,1
n266,selfmotivated,,selfmotivated,selfmotivated,2,16,0,1,1,0,93,0.000088,3,0,1,1
n267,owned,,owned,owned,2,3,0,1,1,0,94,0.000088,15,0,1,1
n268,picks,,picks,picks,2,12,0,1,1,0,95,0.000088,1,0,1,1
n269,term,,term,term,22,8,4,12,16,0,20,0.000467,2,4,5,9
n270,means,,means,means,12,3,3,6,9,0,20,0.000393,15,2,2,4
n271,handson,,handson,handson,16,7,2,2,4,0,20,0.000209,4,0,6,6
n272,imply,,imply,imply,6,4,1,3,4,0,20,0.000121,5,1,1,2
n273,creation,,creation,creation,2,4,0,1,1,0,96,0.000088,0,0,1,1
n274,collaborative,,collaborative,collaborative,32,16,5,2,7,0,20,0.00051,0,0,2,2
n275,role,,role,role,28,4,5,1,6,0,20,0.000396,1,2,3,5
n276,coalesce,,coalesce,coalesce,2,14,1,1,2,0,20,0.000111,1,0,0,0
n277,connect,,connect,connect,20,16,4,10,14,0,20,0.00027,5,2,2,4
n278,ability,,ability,ability,16,16,1,8,9,0,20,0.000111,5,1,3,4
n279,synthesize,,synthesize,synthesize,2,4,1,1,2,0,20,0.000113,0,0,1,1
n280,creative,,creative,creative,10,16,2,5,7,0,102,0.0002,4,1,3,4
n281,spark,,spark,spark,2,16,1,1,2,0,101,0.000122,4,1,0,1
n282,now,,now,now,10,16,0,5,5,0,108,0.000088,5,0,2,2
n283,undertakes,,undertakes,undertakes,2,16,1,1,2,0,107,0.000103,5,1,1,2
n284,task,,task,task,28,8,9,2,11,0,20,0.000596,4,2,4,6
n285,shape,,shape,shape,10,20,1,1,2,0,20,0.000123,3,1,2,3
n286,significant,,significant,significant,6,4,0,3,3,0,110,0.000088,2,0,2,2
n287,thought,,thought,thought,12,5,3,1,4,0,111,0.000366,3,3,2,5
n288,extend,,extend,extend,18,14,3,9,12,0,20,0.000641,7,0,0,0
n289,hisher,,hisher,hisher,4,13,1,2,3,0,20,0.000148,3,0,1,1
n290,previous,,previous,previous,38,13,6,1,7,0,20,0.000903,3,8,7,15
n291,implicit,,implicit,implicit,4,1,1,2,3,0,58,0.000125,0,0,0,0
n292,personal,,personal,personal,8,7,2,1,3,0,20,0.000131,1,1,2,3
n293,social,,social,social,26,8,4,1,5,0,20,0.00067,5,2,2,4
n294,arrangements,,arrangements,arrangements,2,18,0,1,1,0,28,0.000088,4,0,0,0
n295,involve,,involve,involve,44,11,6,2,8,0,20,0.00133,8,4,2,6
n296,listen,,listen,listen,8,6,2,4,6,0,20,0.000229,6,2,1,3
n297,enterprise,,enterprise,enterprise,8,1,1,1,2,0,113,0.000113,0,0,0,0
n298,share,,share,share,34,18,6,5,11,0,12,0.000889,0,0,0,0
n299,built,,built,built,28,11,6,2,8,0,20,0.000585,1,4,2,6
n300,relevance,,relevance,relevance,10,4,2,5,7,0,20,0.000162,3,1,2,3
n301,society,,society,society,2,14,0,1,1,0,114,0.000088,6,0,0,0
n302,compare,,compare,compare,14,3,4,1,5,0,20,0.0004,1,2,2,4
n303,conclusion,,conclusion,conclusion,23,16,4,1,5,0,20,0.00067,1,5,2,7
n304,multiple,,multiple,multiple,10,1,1,5,6,0,20,0.000465,0,0,0,0
n305,media,,media,media,13,6,3,1,4,0,20,0.000387,3,5,2,7
n306,online,,online,online,4,16,1,2,3,0,106,0.000103,5,1,1,2
n307,networks,,networks,networks,2,10,0,1,1,0,115,0.000088,0,0,1,1
n308,tell,,tell,tell,2,1,0,1,1,0,116,0.000088,0,0,0,0
n309,recognise,,recognise,recognise,12,3,2,6,8,0,20,0.000168,5,1,4,5
n310,say,,say,say,10,2,4,5,9,0,20,0.000484,2,4,2,6
n311,whether,,whether,whether,4,10,1,2,3,0,20,0.00017,1,0,1,1
n312,transform,,transform,transform,4,10,1,2,3,0,20,0.00016,1,1,1,2
n313,later,,later,later,8,12,1,4,5,0,20,0.000113,3,1,1,2
n314,work,,work,work,37,5,8,1,9,0,20,0.000443,1,4,2,6
n315,sch¨on1987,,sch¨on1987,sch¨on1987,2,6,0,1,1,0,117,0.000088,1,0,1,1
n316,thereby,,thereby,thereby,2,5,0,1,1,0,118,0.000088,1,0,1,1
n317,able,,able,able,10,5,2,5,7,0,20,0.000188,1,2,2,4
n318,move,,move,move,14,12,4,2,6,0,20,0.000386,4,3,4,7
n319,concept,,concept,concept,131,2,21,1,22,0,20,0.001952,1,13,5,18
n320,indeterminacies,,indeterminacies,indeterminacies,2,3,1,1,2,0,20,0.000112,5,1,1,2
n321,continue,,continue,continue,12,20,2,6,8,0,20,0.000251,1,1,3,4
n322,time,,time,time,29,7,8,14,22,0,20,0.000698,3,6,6,12
n323,back,,back,back,4,12,0,2,2,0,119,0.000088,8,0,1,1
n324,initial,,initial,initial,13,10,2,1,3,0,20,0.000207,3,0,3,3
n325,research,,research,research,30,4,7,2,9,0,20,0.000703,3,4,2,6
n326,made,,made,made,18,15,2,1,3,0,20,0.000532,5,3,2,5
n327,inventory,,inventory,inventory,2,5,0,1,1,0,120,0.000088,3,0,1,1
n328,observation,,observation,observation,82,5,9,1,10,0,20,0.013114,3,14,4,18
n329,decision,,decision,decision,6,1,1,3,4,0,42,0.000125,0,0,0,0
n330,light,,light,light,6,15,1,3,4,0,20,0.000127,7,0,1,1
n331,might,,might,might,10,7,1,5,6,0,20,0.000124,8,0,3,3
n332,circle,,circle,circle,4,7,1,2,3,0,20,0.000111,3,0,1,1
n333,structure,,structure,structure,52,6,8,1,9,0,20,0.000609,4,5,3,8
n334,whereby,,whereby,whereby,6,20,1,3,4,0,122,0.000163,4,1,1,2
n335,pupils,,pupils,pupils,18,1,6,1,7,0,20,0.000476,0,0,0,0
n336,design,,design,design,52,15,10,3,13,0,20,0.001069,2,5,4,9
n337,class,,class,class,16,10,4,1,5,0,20,0.000324,0,1,2,3
n338,activity,,activity,activity,105,7,15,1,16,0,20,0.002051,4,10,0,10
n339,conditions,,conditions,conditions,8,1,1,4,5,0,20,0.000106,0,0,0,0
n340,left,,left,left,2,1,0,1,1,0,124,0.000088,0,0,0,0
n341,unsupported,,unsupported,unsupported,4,1,1,2,3,0,123,0.000163,0,0,0,0
n342,draw,,draw,draw,21,16,5,1,6,0,20,0.000447,1,4,3,7
n343,manage,,manage,manage,6,12,1,3,4,0,20,0.000157,6,0,2,2
n344,impuls,,impuls,impuls,2,1,0,1,1,0,127,0.000088,0,0,0,0
n345,toward,,toward,toward,8,1,2,4,6,0,126,0.00021,0,0,0,0
n346,project,,project,project,18,1,7,9,16,0,20,0.000592,0,0,0,0
n347,goal,,goal,goal,26,18,7,3,10,0,24,0.001484,4,0,0,0
n348,often,,often,often,26,8,4,13,17,0,20,0.000318,3,3,8,11
n349,classroom,,classroom,classroom,32,18,7,1,8,0,29,0.001012,4,0,0,0
n350,sometimes,,sometimes,sometimes,2,13,0,1,1,0,128,0.000088,3,0,1,1
n351,seek,,seek,seek,10,13,3,5,8,0,20,0.000234,3,2,3,5
n352,arouse,,arouse,arouse,4,13,1,2,3,0,20,0.000128,3,1,0,1
n353,times,,times,times,10,6,3,5,8,0,20,0.000363,2,1,1,2
n354,specify,,specify,specify,5,8,3,2,5,0,20,0.000335,5,2,2,4
n355,within,,within,within,44,1,12,4,16,0,20,0.001383,0,0,0,0
n356,group,,group,group,20,3,4,1,5,0,20,0.00073,1,5,2,7
n357,encourage,,encourage,encourage,29,3,3,1,4,0,20,0.000489,2,1,4,5
n358,function,,function,function,16,19,6,8,14,0,20,0.000589,0,4,3,7
n359,scaffold,,scaffold,scaffold,18,8,5,1,6,0,20,0.000292,2,2,2,4
n360,primary,,primary,primary,24,4,3,1,4,0,20,0.025291,7,0,4,4
n361,ahead,,ahead,ahead,2,15,0,1,1,0,130,0.000088,0,0,1,1
n362,signature,,signature,signature,6,15,1,1,2,0,129,0.000163,0,1,3,4
n363,sharply,,sharply,sharply,2,1,0,1,1,0,131,0.000088,0,0,0,0
n364,define,,define,define,12,1,2,6,8,0,20,0.00021,0,0,0,0
n365,instead,,instead,instead,8,1,2,4,6,0,20,0.000146,0,0,0,0
n366,set,,set,set,46,7,8,23,31,0,20,0.000423,8,4,6,10
n367,open,,open,open,32,11,7,1,8,0,20,0.001057,4,4,5,9
n368,end,,end,end,16,11,1,2,3,0,20,0.000986,4,5,2,7
n369,authors,,authors,authors,8,14,1,4,5,0,20,0.000129,6,0,0,0
n370,argue,,argue,argue,22,14,4,2,6,0,20,0.000677,2,0,0,0
n371,general,,general,general,19,4,3,10,13,0,20,0.000274,5,3,3,6
n372,product,,product,product,25,18,3,1,4,0,15,0.000651,0,0,0,0
n373,literacy,,literacy,literacy,12,16,0,6,6,0,134,0.000088,5,0,2,2
n374,unlike,,unlike,unlike,4,3,1,2,3,0,133,0.0001,0,0,2,2
n375,empirical,,empirical,empirical,26,14,4,1,5,0,20,0.001471,2,0,0,0
n376,result,,result,result,43,16,7,1,8,0,20,0.000688,7,4,2,6
n377,alone,,alone,alone,6,11,2,3,5,0,20,0.000232,6,1,2,3
n378,theoretical,,theoretical,theoretical,16,14,5,1,6,0,20,0.000368,2,0,0,0
n379,analyse,,analyse,analyse,38,5,7,1,8,0,3,0.000557,4,7,4,11
n380,removed,,removed,removed,2,1,0,1,1,0,135,0.000088,0,0,0,0
n381,sense,,sense,sense,28,14,6,1,7,0,20,0.000406,1,0,0,0
n382,know,,know,know,36,16,4,18,22,0,20,0.000615,9,7,6,13
n383,attend,,attend,attend,2,12,1,1,2,0,20,0.000117,0,0,1,1
n384,wide,,wide,wide,4,7,1,2,3,0,20,0.000117,5,0,2,2
n385,range,,range,range,6,7,2,3,5,0,20,0.000157,5,2,1,3
n386,show,,show,show,20,3,2,10,12,0,20,0.000442,2,0,4,4
n387,value,,value,value,6,12,2,3,5,0,20,0.000185,8,1,2,3
n388,center,,center,center,22,4,2,11,13,0,20,0.000183,8,1,5,6
n389,orient,,orient,orient,12,4,2,6,8,0,20,0.000182,5,2,1,3
n390,powerful,,powerful,powerful,8,15,0,4,4,0,137,0.000088,5,0,1,1
n391,live_habitat,,live_habitat,live_habitat,8,1,1,1,2,0,20,0.00022,0,0,0,0
n392,report,,report,report,20,10,8,1,9,0,20,0.00064,0,3,2,5
n393,detail,,detail,detail,6,1,1,3,4,0,20,0.000135,0,0,0,0
n394,employ,,employ,employ,12,14,2,1,3,0,20,0.000253,4,0,0,0
n395,soundness,,soundness,soundness,2,1,0,1,1,0,138,0.000088,0,0,0,0
n396,viability,,viability,viability,2,1,1,1,2,0,20,0.000225,0,0,0,0
n397,enriched,,enriched,enriched,6,1,0,3,3,0,139,0.000088,0,0,0,0
n398,enable,,enable,enable,18,3,2,1,3,0,20,0.000624,5,2,3,5
n399,offering,,offering,offering,2,13,0,1,1,0,140,0.000088,3,0,1,1
n400,entry,,entry,entry,6,2,0,1,1,0,141,0.000088,0,0,2,2
n401,picture,,picture,picture,5,11,1,2,3,0,99,0.000191,3,1,2,3
n402,facilitate,,facilitate,facilitate,14,3,3,1,4,0,20,0.000292,14,2,2,4
n403,sustain,,sustain,sustain,4,14,0,2,2,0,142,0.000088,1,0,0,0
n404,expand,,expand,expand,8,13,3,4,7,0,20,0.00035,3,2,3,5
n405,review,,review,review,6,18,0,3,3,0,30,0.000088,0,0,0,0
n406,outputs,,outputs,outputs,2,11,1,1,2,0,100,0.000122,3,0,1,1
n407,story,,story,story,4,11,2,2,4,0,98,0.000244,3,2,0,2
n408,web,,web,web,6,13,2,3,5,0,20,0.000293,5,1,2,3
n409,site,,site,site,1,13,1,0,1,0,17,0.000171,5,1,0,1
n410,school,,school,school,16,7,4,8,12,0,20,0.000402,3,4,3,7
n411,university,,university,university,4,17,2,2,4,0,20,0.000202,3,0,2,2
n412,partner,,partner,partner,6,17,2,3,5,0,20,0.000211,3,2,2,4
n413,sought,,sought,sought,2,17,1,1,2,0,20,0.000148,3,1,0,1
n414,science,,science,science,526,1,102,1,103,0,20,0.046171,0,0,0,0
n415,formal,,formal,formal,4,1,1,2,3,0,20,0.000131,0,0,0,0
n416,introduce,,introduce,introduce,20,3,5,1,6,0,20,0.000331,2,2,3,5
n417,infer,,infer,infer,12,16,1,6,7,0,20,0.000117,7,1,3,4
n418,evidence,,evidence,evidence,67,14,15,2,17,0,20,0.021192,2,0,0,0
n419,qualitative,,qualitative,qualitative,4,4,1,2,3,0,20,0.000123,3,0,2,2
n420,quantitative,,quantitative,quantitative,2,4,1,1,2,0,11,0.00014,3,1,0,1
n421,data,,data,data,88,5,14,1,15,0,1,0.006906,4,19,4,23
n422,confirm,,confirm,confirm,17,13,3,1,4,0,20,0.000285,6,3,3,6
n423,derived,,derived,derived,4,7,0,2,2,0,144,0.000088,3,0,1,1
n424,logical,,logical,logical,12,16,2,1,3,0,20,0.000179,4,2,2,4
n425,interpret,,interpret,interpret,34,5,6,1,7,0,20,0.011474,3,8,0,8
n426,based,,based,based,46,5,5,1,6,0,20,0.000756,0,2,2,4
n427,young,,young,young,66,3,15,1,16,0,20,0.000739,2,6,30,36
n428,attain,,attain,attain,2,1,0,1,1,0,145,0.000088,0,0,0,0
n429,specific,,specific,specific,36,1,3,1,4,0,20,0.000155,0,0,0,0
n430,strategy,,strategy,strategy,8,10,0,4,4,0,150,0.000088,2,0,1,1
n431,attainment,,attainment,attainment,2,10,1,1,2,0,20,0.000123,2,1,1,2
n432,akersonvolrich2006,,akersonvolrich2006,akersonvolrich2006,2,10,1,1,2,0,20,0.000192,2,1,1,2
n433,khishfeabdelkhalick2002,,khishfeabdelkhalick2002,khishfeabdelkhalick2002,2,10,1,1,2,0,20,0.000251,2,1,1,2
n434,metz2004,,metz2004,metz2004,5,10,1,2,3,0,20,0.000302,2,1,1,2
n435,throughout,,throughout,throughout,8,5,1,4,5,0,20,0.000123,4,0,2,2
n436,documents,,documents,documents,2,5,1,1,2,0,20,0.000114,4,1,0,1
n437,scientist,,scientist,scientist,18,1,1,9,10,0,167,0.000163,0,0,0,0
n438,done,,done,done,8,1,2,4,6,0,20,0.000138,0,0,0,0
n439,repeat,,repeat,repeat,6,10,2,3,5,0,20,0.000305,4,1,1,2
n440,increase,,increase,increase,8,10,2,4,6,0,20,0.000189,4,1,1,2
n441,level,,level,level,28,10,6,2,8,0,20,0.000486,3,7,2,9
n442,proficient,,proficient,proficient,12,13,1,6,7,0,20,0.000487,8,3,0,3
n443,bybee2011,,bybee2011,bybee2011,2,10,1,1,2,0,20,0.000157,4,0,1,1
n444,michaelsetal2008,,michaelsetal2008,michaelsetal2008,2,10,1,1,2,0,20,0.000221,4,1,1,2
n445,crosscutting,,crosscutting,crosscutting,4,2,1,1,2,0,168,0.000107,1,0,2,2
n446,disciplinary,,disciplinary,disciplinary,2,14,0,1,1,0,169,0.000088,2,0,0,0
n447,engineering,,engineering,engineering,6,6,1,3,4,0,20,0.000106,0,0,1,1
n448,worldview,,worldview,worldview,2,6,1,1,2,0,5,0.000112,5,1,1,2
n449,nrc2012p42,,nrc2012p42,nrc2012p42,1,6,1,0,1,0,4,0.000183,5,1,0,1
n450,good,,good,good,5,16,2,3,5,0,20,0.000273,2,2,1,3
n451,frame,,frame,frame,14,3,1,7,8,0,173,0.000113,4,0,2,2
n452,anderson2002,,anderson2002,anderson2002,6,1,1,3,4,0,166,0.000103,0,0,0,0
n453,framework,,framework,framework,14,1,3,7,10,0,165,0.000267,0,0,0,0
n454,instruction,,instruction,instruction,66,14,7,1,8,0,20,0.000908,4,0,0,0
n455,und,,und,und,2,14,0,1,1,0,174,0.000088,3,0,0,0
n456,evaluate,,evaluate,evaluate,37,14,6,2,8,0,20,0.001402,3,0,0,0
n457,furtaketal2012,,furtaketal2012,furtaketal2012,7,6,0,4,4,0,175,0.000088,7,0,1,1
n458,suggest,,suggest,suggest,18,16,5,9,14,0,20,0.000501,2,3,3,6
n459,two,,two,two,12,1,5,1,6,0,20,0.000458,0,0,0,0
n460,cognitive,,cognitive,cognitive,38,18,8,2,10,0,9,0.000562,5,0,0,0
n461,regard,,regard,regard,19,8,6,1,7,0,20,0.000238,2,3,0,3
n462,minneretal2009,,minneretal2009,minneretal2009,2,16,0,1,1,0,176,0.000088,1,0,1,1
n463,p20,,p20,p20,2,11,0,1,1,0,182,0.000088,7,0,1,1
n464,consistent,,consistent,consistent,5,11,3,2,5,0,181,0.000219,7,3,1,4
n465,duschl2008,,duschl2008,duschl2008,4,11,1,2,3,0,180,0.000181,7,1,1,2
n466,identify,,identify,identify,20,14,3,1,4,0,20,0.000238,6,0,0,0
n467,epistemic,,epistemic,epistemic,20,15,2,1,3,0,20,0.000229,7,2,2,4
n468,domain,,domain,domain,20,6,3,1,4,0,20,0.000197,3,1,2,3
n469,principle,,principle,principle,12,15,2,6,8,0,20,0.000465,2,3,1,4
n470,consist,,consist,consist,16,5,1,1,2,0,20,0.000195,3,0,3,3
n471,generate,,generate,generate,26,5,3,2,5,0,20,0.000701,5,3,4,7
n472,comprise,,comprise,comprise,6,5,0,3,3,0,183,0.000088,6,0,1,1
n473,realize,,realize,realize,2,1,0,1,1,0,184,0.000088,0,0,0,0
n474,curriculum,,curriculum,curriculum,34,2,7,2,9,0,20,0.000603,1,3,0,3
n475,instance,,instance,instance,4,6,1,2,3,0,185,0.000226,3,1,1,2
n476,ibse,,ibse,ibse,3,6,0,2,2,0,186,0.000088,6,0,1,1
n477,commonly,,commonly,commonly,6,6,3,3,6,0,20,0.000233,6,3,1,4
n478,according,,according,according,18,13,5,10,15,0,20,0.000708,2,2,1,3
n479,degree,,degree,degree,8,1,3,1,4,0,20,0.000216,0,0,0,0
n480,free,,free,free,12,3,1,1,2,0,20,0.000203,4,0,2,2
n481,operate,,operate,operate,6,14,0,3,3,0,189,0.000088,6,0,0,0
n482,belletal2005,,belletal2005,belletal2005,2,4,0,1,1,0,190,0.000088,6,0,1,1
n483,accompanied,,accompanied,accompanied,6,4,3,3,6,0,20,0.000377,6,2,2,4
n484,debate,,debate,debate,4,4,2,2,4,0,20,0.000247,6,1,1,2
n485,effect,,effect,effect,26,14,8,1,9,0,20,0.000548,6,0,0,0
n486,minimally,,minimally,minimally,2,1,0,1,1,0,191,0.000088,0,0,0,0
n487,versus,,versus,versus,2,1,0,1,1,0,192,0.000088,0,0,0,0
n488,hmelosilveretal2007,,hmelosilveretal2007,hmelosilveretal2007,6,12,2,3,5,0,20,0.000196,6,1,2,3
n489,kirschneretal2006,,kirschneretal2006,kirschneretal2006,4,12,1,2,3,0,20,0.000143,6,1,2,3
n490,typical,,typical,typical,11,12,2,1,3,0,20,0.000204,8,1,2,3
n491,ie,,ie,ie,10,7,1,5,6,0,20,0.000114,5,0,3,3
n492,however,,however,however,28,4,5,14,19,0,20,0.000543,5,4,5,9
n493,peers,,peers,peers,8,9,1,4,5,0,20,0.000282,2,0,0,0
n494,high,,high,high,12,10,2,2,4,0,20,0.000139,3,0,4,4
n495,particular,,particular,particular,19,2,4,10,14,0,20,0.000446,5,3,2,5
n496,fostering,,fostering,fostering,4,12,0,2,2,0,193,0.000088,0,0,1,1
n497,subject,,subject,subject,6,14,1,1,2,0,197,0.000125,5,0,0,0
n498,matter,,matter,matter,8,14,1,1,2,0,196,0.000194,5,0,0,0
n499,complex,,complex,complex,14,6,2,2,4,0,20,0.000213,0,2,2,4
n500,limit,,limit,limit,10,6,3,5,8,0,20,0.000256,7,3,2,5
n501,hardyetal2006,,hardyetal2006,hardyetal2006,4,6,2,2,4,0,20,0.00015,7,2,1,3
n502,large,,large,large,4,13,2,2,4,0,20,0.00024,0,0,2,2
n503,body,,body,body,8,13,3,1,4,0,20,0.000363,3,2,2,4
n504,far,,far,far,2,1,0,1,1,0,198,0.000088,0,0,0,0
n505,propose,,propose,propose,10,14,4,5,9,0,20,0.000197,7,0,0,0
n506,treagustduit2008,,treagustduit2008,treagustduit2008,2,4,1,1,2,0,20,0.000121,1,0,1,1
n507,reach,,reach,reach,10,13,1,5,6,0,20,0.000138,4,0,2,2
n508,consider,,consider,consider,18,16,3,1,4,0,20,0.000205,0,0,2,2
n509,slow,,slow,slow,2,16,0,1,1,0,200,0.000088,3,0,1,1
n510,gradual,,gradual,gradual,2,16,1,1,2,0,199,0.000163,3,1,1,2
n511,rather,,rather,rather,10,2,1,5,6,0,203,0.000163,3,1,3,4
n512,dramatic,,dramatic,dramatic,4,2,2,2,4,0,20,0.000188,3,2,2,4
n513,gestalttype,,gestalttype,gestalttype,2,2,1,1,2,0,20,0.000168,3,1,0,1
n514,shift,,shift,shift,4,3,2,2,4,0,20,0.000382,6,1,2,3
n515,paradigms,,paradigms,paradigms,2,3,1,1,2,0,20,0.00025,6,1,1,2
n516,caravitahallden1994,,caravitahallden1994,caravitahallden1994,2,3,1,1,2,0,20,0.0003,6,1,1,2
n517,spontaneous,,spontaneous,spontaneous,4,6,0,2,2,0,204,0.000088,0,0,1,1
n518,explanation,,explanation,explanation,66,13,11,3,14,0,20,0.001091,1,9,0,9
n519,phenomenon,,phenomenon,phenomenon,23,7,2,12,14,0,20,0.005325,1,3,3,6
n520,daily,,daily,daily,6,7,1,3,4,0,20,0.000465,1,1,1,2
n521,life,,life,life,14,7,3,1,4,0,20,0.000322,1,2,2,4
n522,carey2000,,carey2000,carey2000,2,1,0,1,1,0,205,0.000088,0,0,0,0
n523,view,,view,view,14,3,4,1,5,0,20,0.000316,10,2,3,5
n524,preinstructional,,preinstructional,preinstructional,2,2,0,1,1,0,206,0.000088,1,0,1,1
n525,partially,,partially,partially,2,8,1,1,2,0,20,0.000109,3,1,1,2
n526,entirely,,entirely,entirely,2,8,1,1,2,0,20,0.00018,3,1,1,2
n527,inadequate,,inadequate,inadequate,2,8,1,1,2,0,20,0.000241,3,1,1,2
n528,furthermore,,furthermore,furthermore,6,8,1,3,4,0,20,0.000293,3,1,1,2
n529,place,,place,place,26,12,6,1,7,0,20,0.001619,8,9,0,9
n530,demands,,demands,demands,2,12,0,1,1,0,207,0.000088,0,0,1,1
n531,language,,language,language,28,13,7,1,8,0,20,0.00047,8,6,3,9
n532,summarize,,summarize,summarize,8,1,1,5,6,0,210,0.000226,0,0,0,0
n533,oral,,oral,oral,4,13,2,1,3,0,20,0.000179,2,2,2,4
n534,write,,write,write,10,13,2,5,7,0,20,0.000305,2,2,2,4
n535,leefradd1998,,leefradd1998,leefradd1998,2,13,1,1,2,0,20,0.000187,8,1,1,2
n536,sufficient,,sufficient,sufficient,6,13,2,3,5,0,20,0.00029,8,1,1,2
n537,explain,,explain,explain,26,14,3,1,4,0,20,0.000648,3,0,0,0
n538,akersonetal2000,,akersonetal2000,akersonetal2000,2,13,0,1,1,0,214,0.000088,2,0,1,1
n539,osborneetal2004,,osborneetal2004,osborneetal2004,2,13,1,1,2,0,213,0.000163,2,1,1,2
n540,van,,van,van,2,13,1,1,2,0,212,0.000226,2,1,1,2
n541,boxteletal2000,,boxteletal2000,boxteletal2000,2,13,1,1,2,0,211,0.00028,2,1,1,2
n542,skill,,skill,skill,98,16,15,1,16,0,20,0.004294,3,19,0,19
n543,tractable,,tractable,tractable,2,9,0,1,1,0,215,0.000088,6,0,0,0
n544,difficult,,difficult,difficult,6,9,2,3,5,0,20,0.000357,6,0,0,0
n545,add,,add,add,14,12,6,1,7,0,20,0.000477,6,3,0,3
n546,poor,,poor,poor,2,13,0,1,1,0,216,0.000088,8,0,1,1
n547,hence,,hence,hence,4,12,1,2,3,0,20,0.000157,2,0,2,2
n548,especially,,especially,especially,6,12,2,3,5,0,20,0.000229,2,2,1,3
n549,beneficial,,beneficial,beneficial,2,12,1,1,2,0,20,0.000153,2,1,1,2
n550,risk,,risk,risk,6,10,1,3,4,0,218,0.000258,6,2,2,4
n551,achieve,,achieve,achieve,6,8,3,3,6,0,20,0.000337,7,2,1,3
n552,lamainalapates,,lamainalapates,lamainalapates,3,2,1,2,3,0,219,0.00028,4,1,1,2
n553,program,,program,program,14,1,5,7,12,0,20,0.000561,0,0,0,0
n554,advocates,,advocates,advocates,4,1,2,2,4,0,20,0.000231,0,0,0,0
n555,incites,,incites,incites,2,3,0,1,1,0,220,0.000088,2,0,1,1
n556,around,,around,around,26,8,2,1,3,0,20,0.029579,0,11,0,11
n557,acquire,,acquire,acquire,14,1,3,7,10,0,20,0.000225,0,0,0,0
n558,content,,content,content,31,13,5,1,6,0,20,0.000554,3,3,4,7
n559,reason,,reason,reason,4,7,1,2,3,0,222,0.000163,0,1,2,3
n560,master,,master,master,4,7,1,2,3,0,221,0.000157,0,1,0,1
n561,french,,french,french,1,1,0,1,1,0,223,0.000088,0,0,0,0
n562,shares,,shares,shares,4,1,1,2,3,0,20,0.000156,0,0,0,0
n563,broad,,broad,broad,10,1,3,5,8,0,20,0.000273,0,0,0,0
n564,main,,main,main,6,18,1,3,4,0,31,0.000125,4,0,0,0
n565,contribute,,contribute,contribute,4,2,0,2,2,0,226,0.000088,1,0,2,2
n566,critical,,critical,critical,24,16,2,1,3,0,97,0.000324,4,3,4,7
n567,thinking,,thinking,thinking,32,16,4,1,5,0,20,0.000513,3,2,3,5
n568,lamainalapates2000,,lamainalapates2000,lamainalapates2000,2,2,0,1,1,0,229,0.000088,4,0,1,1
n569,saltiel2006,,saltiel2006,saltiel2006,2,2,1,1,2,0,228,0.000163,4,1,1,2
n570,sarmantetal2011,,sarmantetal2011,sarmantetal2011,2,2,1,1,2,0,227,0.000226,4,1,1,2
n571,promote,,promote,promote,10,2,3,5,8,0,20,0.000741,4,2,3,5
n572,expected,,expected,expected,12,13,1,6,7,0,105,0.000103,6,0,2,2
n573,carry,,carry,carry,16,5,2,1,3,0,104,0.000241,7,1,2,3
n574,raise,,raise,raise,8,5,2,4,6,0,20,0.000138,7,1,1,2
n575,vital,,vital,vital,10,3,2,5,7,0,20,0.000389,14,2,2,4
n576,influence,,influence,influence,10,19,3,5,8,0,20,0.000242,3,0,2,2
n577,5e,,5e,5e,32,14,7,1,8,0,20,0.000544,4,0,0,0
n578,bybeeetal2006,,bybeeetal2006,bybeeetal2006,10,15,1,5,6,0,20,0.000135,3,1,3,4
n579,biological,,biological,biological,8,1,2,1,3,0,20,0.000163,0,0,0,0
n580,get,,get,get,8,7,1,4,5,0,20,0.000131,10,1,2,3
n581,sequence,,sequence,sequence,16,7,4,1,5,0,20,0.000438,4,1,2,3
n582,atkinskarplus1962,,atkinskarplus1962,atkinskarplus1962,4,3,0,2,2,0,233,0.000088,0,0,2,2
n583,formation,,formation,formation,2,13,0,1,1,0,235,0.000088,3,0,1,1
n584,extension,,extension,extension,2,13,1,1,2,0,234,0.000163,3,1,1,2
n585,3e,,3e,3e,2,1,0,1,1,0,236,0.000088,0,0,0,0
n586,piagets,,piagets,piagets,4,19,1,2,3,0,20,0.000129,3,1,1,2
n587,mental,,mental,mental,6,19,2,3,5,0,20,0.000217,3,2,1,3
n588,marek2008,,marek2008,marek2008,2,14,0,1,1,0,237,0.000088,4,0,0,0
n589,establish,,establish,establish,8,6,1,4,5,0,20,0.000123,4,0,1,1
n590,constructivism,,constructivism,constructivism,10,14,3,5,8,0,20,0.00072,1,0,0,0
n591,approach,,approach,approach,40,3,9,2,11,0,20,0.00072,3,5,2,7
n592,assume,,assume,assume,10,14,2,1,3,0,20,0.000315,6,0,0,0
n593,bring,,bring,bring,6,14,2,3,5,0,20,0.000226,7,0,0,0
n594,test,,test,test,14,13,4,7,11,0,20,0.00044,4,1,4,5
n595,exist,,exist,exist,10,13,2,5,7,0,20,0.000202,3,1,2,3
n596,real,,real,real,20,8,6,1,7,0,20,0.000533,1,4,2,6
n597,family,,family,family,8,2,2,4,6,0,20,0.000418,6,2,3,5
n598,easy,,easy,easy,6,2,1,3,4,0,20,0.000177,6,1,1,2
n599,assimilated,,assimilated,assimilated,2,2,1,1,2,0,20,0.000138,6,1,0,1
n600,accommodation,,accommodation,accommodation,2,14,0,1,1,0,238,0.000088,3,0,0,0
n601,fit,,fit,fit,8,14,3,1,4,0,20,0.000842,3,0,0,0
n602,unfamiliar,,unfamiliar,unfamiliar,6,9,1,3,4,0,20,0.000117,4,0,0,0
n603,colburn2003,,colburn2003,colburn2003,2,14,1,1,2,0,188,0.000113,6,0,0,0
n604,researchbased,,researchbased,researchbased,2,14,1,1,2,0,187,0.000184,6,0,0,0
n605,incorporate,,incorporate,incorporate,13,3,2,7,9,0,20,0.000147,4,2,3,5
n606,notion,,notion,notion,10,3,3,5,8,0,20,0.000174,4,2,2,4
n607,cooperation,,cooperation,cooperation,2,7,1,1,2,0,20,0.000103,8,1,0,1
n608,coconstruct,,coconstruct,coconstruct,10,14,1,1,2,0,239,0.000173,2,0,0,0
n609,essential,,essential,essential,10,3,1,1,2,0,20,0.000111,8,0,2,2
n610,itemized,,itemized,itemized,2,20,0,1,1,0,240,0.000088,0,0,1,1
n611,manner,,manner,manner,6,20,2,3,5,0,20,0.000221,2,2,1,3
n612,guest,,guest,guest,2,20,1,1,2,0,20,0.000151,2,1,1,2
n613,editorial,,editorial,editorial,2,20,1,1,2,0,20,0.000216,2,1,1,2
n614,bybee2014,,bybee2014,bybee2014,2,20,1,1,2,0,20,0.000271,2,1,0,1
n615,respond,,respond,respond,6,5,0,1,1,0,241,0.000088,0,0,2,2
n616,recommend,,recommend,recommend,14,4,5,7,12,0,20,0.000577,3,3,3,6
n617,enumerates,,enumerates,enumerates,2,9,1,1,2,0,20,0.000158,0,0,0,0
n618,implications,,implications,implications,2,9,1,1,2,0,20,0.000222,0,0,0,0
n619,usage,,usage,usage,2,9,1,1,2,0,20,0.000277,0,0,0,0
n620,application,,application,application,6,9,3,3,6,0,20,0.00049,0,0,0,0
n621,era,,era,era,2,9,1,1,2,0,20,0.000227,0,0,0,0
n622,generation,,generation,generation,6,1,1,1,2,0,20,0.000392,0,0,0,0
n623,standard,,standard,standard,14,3,0,7,7,0,248,0.000088,4,0,4,4
n624,ngss2013,,ngss2013,ngss2013,2,3,1,1,2,0,247,0.000099,4,1,0,1
n625,preferable,,preferable,preferable,2,4,1,1,2,0,20,0.000158,3,1,1,2
n626,timeframe,,timeframe,timeframe,2,4,1,1,2,0,20,0.000222,3,1,1,2
n627,longterm,,longterm,longterm,8,4,1,4,5,0,20,0.000277,3,1,1,2
n628,period,,period,period,8,2,1,4,5,0,20,0.000147,0,0,2,2
n629,unit,,unit,unit,13,5,2,6,8,0,20,0.000203,6,2,3,5
n630,spanning,,spanning,spanning,2,5,0,1,1,0,250,0.000088,1,0,1,1
n631,2–3,,2–3,2–3,2,5,1,1,2,0,249,0.000163,1,1,1,2
n632,week,,week,week,6,5,3,3,6,0,20,0.000294,1,2,1,3
n633,lose,,lose,lose,6,2,2,3,5,0,20,0.000267,5,1,1,2
n634,bybee,,bybee,bybee,2,4,1,1,2,0,20,0.000148,3,0,1,1
n635,omitting,,omitting,omitting,2,4,1,1,2,0,20,0.000125,2,0,1,1
n636,nrc1999,,nrc1999,nrc1999,2,15,1,1,2,0,20,0.000111,3,1,1,2
n637,rearranging,,rearranging,rearranging,2,15,1,1,2,0,20,0.000182,3,1,0,1
n638,renner,,renner,renner,2,16,0,1,1,0,252,0.000088,7,0,1,1
n639,abrahambernie1988,,abrahambernie1988,abrahambernie1988,2,16,1,1,2,0,251,0.000163,7,1,1,2
n640,integrity,,integrity,integrity,2,1,0,1,1,0,253,0.000088,0,0,0,0
n641,seem,,seem,seem,9,7,1,5,6,0,20,0.000109,8,1,2,3
n642,inflexible,,inflexible,inflexible,2,7,0,1,1,0,254,0.000088,8,0,1,1
n643,suitable,,suitable,suitable,4,7,2,2,4,0,20,0.000181,8,2,0,2
n644,childhood,,childhood,childhood,42,4,1,2,3,0,20,0.002745,4,21,8,29
n645,repetition,,repetition,repetition,2,4,0,1,1,0,255,0.000088,2,0,1,1
n646,chance,,chance,chance,6,7,1,3,4,0,20,0.000204,10,1,0,1
n647,flexibility,,flexibility,flexibility,4,12,1,2,3,0,20,0.000257,6,1,2,3
n648,prerequisite,,prerequisite,prerequisite,4,13,0,2,2,0,257,0.000088,5,0,2,2
n649,deem,,deem,deem,2,4,1,1,2,0,20,0.000113,5,0,1,1
n650,necessary,,necessary,necessary,8,4,2,4,6,0,20,0.000203,5,1,2,3
n651,grade,,grade,grade,6,4,0,3,3,0,259,0.000088,5,0,2,2
n652,yoononchwari2006,,yoononchwari2006,yoononchwari2006,2,4,1,1,2,0,258,0.000113,5,1,1,2
n653,kindergartener,,kindergartener,kindergartener,50,9,10,1,11,0,20,0.001463,1,0,0,0
n654,fledgling,,fledgling,fledgling,2,7,1,1,2,0,20,0.000139,8,1,0,1
n655,milleretal2013,,milleretal2013,milleretal2013,2,7,1,1,2,0,20,0.000113,5,0,1,1
n656,last,,last,last,4,7,2,2,4,0,20,0.000259,5,2,2,4
n657,century,,century,century,2,7,1,1,2,0,20,0.000198,5,1,0,1
n658,investigative,,investigative,investigative,10,5,1,1,2,0,20,0.000165,0,0,3,3
n659,competence,,competence,competence,2,1,0,1,1,0,260,0.000088,0,0,0,0
n660,compatible,,compatible,compatible,2,3,0,1,1,0,261,0.000088,2,0,1,1
n662,integrate,,integrate,integrate,11,13,2,6,8,0,20,0.000225,8,1,2,3
n663,nsta2014,,nsta2014,nsta2014,2,17,0,1,1,0,263,0.000088,0,0,1,1
n664,position,,position,position,6,17,2,1,3,0,262,0.000301,0,2,2,4
n665,declares,,declares,declares,2,2,0,1,1,0,264,0.000088,4,0,1,1
n666,educators,,educators,educators,10,3,2,5,7,0,148,0.000208,5,2,3,5
n667,nurture,,nurture,nurture,2,3,1,1,2,0,20,0.000112,5,1,1,2
n668,focus,,focus,focus,42,3,9,1,10,0,20,0.001978,2,3,4,7
n669,ngssleadstates2013,,ngssleadstates2013,ngssleadstates2013,2,3,1,1,2,0,246,0.000099,4,1,1,2
n670,academic,,academic,academic,4,17,0,2,2,0,265,0.000088,3,0,1,1
n671,modify,,modify,modify,10,14,2,5,7,0,20,0.000189,4,0,0,0
n672,version,,version,version,8,14,3,4,7,0,20,0.000234,4,0,0,0
n673,method,,method,method,31,14,2,2,4,0,20,0.000136,4,0,0,0
n674,course,,course,course,6,4,2,3,5,0,266,0.000237,8,2,2,4
n675,midwest,,midwest,midwest,4,4,2,2,4,0,20,0.000169,8,2,1,3
n676,united,,united,united,10,17,2,1,3,0,20,0.000294,0,2,5,7
n677,20,,20,20,2,3,0,1,1,0,267,0.000088,2,0,1,1
n678,4year,,4year,4year,2,3,0,1,1,0,268,0.000088,0,0,1,1
n679,old,,old,old,6,3,3,1,4,0,20,0.000235,0,3,3,6
n680,taught,,taught,taught,10,4,3,5,8,0,20,0.000336,8,2,2,4
n681,preservice,,preservice,preservice,10,4,1,1,2,0,20,0.000145,1,1,4,5
n682,enrolled,,enrolled,enrolled,2,4,0,1,1,0,269,0.000088,8,0,1,1
n683,major,,major,major,4,7,1,2,3,0,20,0.000323,9,1,1,2
n684,field,,field,field,8,7,2,1,3,0,20,0.000145,1,2,2,4
n685,requirement,,requirement,requirement,2,4,0,1,1,0,270,0.000088,8,0,1,1
n686,lesson,,lesson,lesson,16,9,4,2,6,0,20,0.000266,7,0,0,0
n687,plan,,plan,plan,22,9,4,1,5,0,20,0.000283,7,0,0,0
n688,adult,,adult,adult,26,9,9,13,22,0,20,0.002149,2,0,0,0
n689,assign,,assign,assign,6,9,1,3,4,0,20,0.000181,6,0,0,0
n690,voluntary,,voluntary,voluntary,2,12,0,1,1,0,271,0.000088,3,0,1,1
n691,first,,first,first,10,12,2,5,7,0,20,0.000188,3,2,1,3
n692,outdoor,,outdoor,outdoor,8,7,1,1,2,0,20,0.000103,3,1,2,3
n693,acreage,,acreage,acreage,2,15,1,1,2,0,20,0.000102,2,0,1,1
n694,frequent,,frequent,frequent,8,11,3,1,4,0,20,0.000387,5,2,2,4
n695,climbing,,climbing,climbing,2,6,0,1,1,0,274,0.000088,8,0,1,1
n696,logs,,logs,logs,2,6,1,1,2,0,273,0.000163,8,1,1,2
n697,wood,,wood,wood,4,6,2,2,4,0,272,0.000364,8,2,2,4
n698,grounded,,grounded,grounded,6,1,1,3,4,0,20,0.000156,0,0,0,0
n699,dam,,dam,dam,2,6,0,1,1,0,275,0.000088,2,0,1,1
n700,ditch,,ditch,ditch,2,6,0,1,1,0,277,0.000088,8,0,1,1
n701,piece,,piece,piece,2,6,1,1,2,0,276,0.000163,8,1,1,2
n702,chasing,,chasing,chasing,2,6,1,1,2,0,20,0.00015,2,1,1,2
n703,frog,,frog,frog,2,6,1,1,2,0,20,0.000215,2,1,1,2
n704,space,,space,space,4,6,0,2,2,0,278,0.000088,2,0,1,1
n705,crevice,,crevice,crevice,2,8,1,1,2,0,20,0.00012,7,1,0,1
n706,spiders,,spiders,spiders,2,3,0,1,1,0,279,0.000088,2,0,1,1
n707,excited,,excited,excited,2,7,0,1,1,0,280,0.000088,1,0,1,1
n708,independent,,independent,independent,4,11,1,2,3,0,20,0.000126,3,0,1,1
n709,session,,session,session,3,7,0,2,2,0,281,0.000088,1,0,1,1
n710,topic,,topic,topic,13,3,1,6,7,0,20,0.000106,4,1,2,3
n711,plant,,plant,plant,10,9,5,1,6,0,20,0.000344,4,0,0,0
n712,animal,,animal,animal,8,9,2,4,6,0,283,0.000187,4,0,0,0
n713,characteristic,,characteristic,characteristic,6,1,3,3,6,0,20,0.000171,0,0,0,0
n714,habitat,,habitat,habitat,2,2,1,1,2,0,20,0.000136,1,0,1,1
n715,landscape,,landscape,landscape,4,15,1,2,3,0,20,0.000111,3,0,1,1
n716,attribute,,attribute,attribute,4,15,1,2,3,0,20,0.000111,3,1,0,1
n717,robust,,robust,robust,4,13,1,2,3,0,284,0.000163,1,1,1,2
n718,namely,,namely,namely,2,5,1,1,2,0,20,0.000113,1,1,0,1
n719,elaborate,,elaborate,elaborate,16,14,4,1,5,0,20,0.001201,3,0,0,0
n720,describe_ption,,describe_ption,describe_ption,19,16,6,2,8,0,20,0.000551,6,6,2,8
n721,purpose,,purpose,purpose,12,4,1,1,2,0,20,0.000121,2,1,4,5
n722,text,,text,text,6,9,1,3,4,0,286,0.000226,7,0,0,0
n723,perceive,,perceive,perceive,4,3,0,2,2,0,289,0.000088,7,0,2,2
n724,culture–historical,,culture–historical,culture–historical,2,3,1,1,2,0,288,0.000125,7,1,1,2
n725,viewpoint,,viewpoint,viewpoint,2,3,1,1,2,0,287,0.000194,7,1,0,1
n726,section,,section,section,3,12,2,0,2,0,16,0.00025,3,2,0,2
n727,trundleetal2010,,trundleetal2010,trundleetal2010,2,13,0,1,1,0,290,0.000088,4,0,1,1
n728,contemporary,,contemporary,contemporary,4,1,1,2,3,0,20,0.000157,0,0,0,0
n729,intuitive,,intuitive,intuitive,8,4,0,1,1,0,291,0.000088,1,0,2,2
n730,gopnik2012,,gopnik2012,gopnik2012,2,5,0,1,1,0,292,0.000088,1,0,1,1
n731,study_teacher,,study_teacher,study_teacher,2,9,0,1,1,0,293,0.000088,1,0,0,0
n732,provocateur,,provocateur,provocateur,6,12,1,1,2,0,47,0.000163,4,2,2,4
n733,wien2014,,wien2014,wien2014,2,13,0,1,1,0,294,0.000088,1,0,1,1
n734,central,,central,central,14,14,3,7,10,0,20,0.000197,1,0,0,0
n735,tenets,,tenets,tenets,6,14,2,1,3,0,20,0.000172,1,0,0,0
n736,reformbased,,reformbased,reformbased,2,4,0,1,1,0,295,0.000088,1,0,1,1
n737,bransfordetal2000,,bransfordetal2000,bransfordetal2000,2,1,0,1,1,0,296,0.000088,0,0,0,0
n738,small,,small,small,9,3,1,1,2,0,297,0.00017,1,0,2,2
n739,krajciketal2003,,krajciketal2003,krajciketal2003,2,17,0,1,1,0,299,0.000088,2,0,1,1
n740,2014,,2014,2014,2,17,1,1,2,0,298,0.000163,2,1,1,2
n741,national,,national,national,10,4,3,2,5,0,20,0.000463,3,1,2,3
n742,associate,,associate,associate,10,1,0,1,1,0,300,0.000088,0,0,0,0
n743,nsta,,nsta,nsta,2,3,0,1,1,0,302,0.000088,14,0,1,1
n744,stressed,,stressed,stressed,2,3,1,1,2,0,301,0.000163,14,1,1,2
n745,order,,order,order,22,10,6,1,7,0,20,0.000435,3,3,0,3
n746,strengthen,,strengthen,strengthen,4,12,0,2,2,0,303,0.000088,0,0,1,1
n747,council,,council,council,2,4,0,1,1,0,304,0.000088,3,0,1,1
n748,nrc20072012,,nrc20072012,nrc20072012,2,4,0,1,1,0,305,0.000088,3,0,1,1
n749,drive,,drive,drive,6,1,0,3,3,0,306,0.000088,0,0,0,0
n750,conduct,,conduct,conduct,12,11,0,1,1,0,307,0.000088,3,0,2,2
n751,appropriate,,appropriate,appropriate,26,15,5,1,6,0,20,0.000403,4,5,2,7
n752,tool,,tool,tool,22,15,3,2,5,0,20,0.001174,5,6,2,8
n753,equipment,,equipment,equipment,2,1,0,1,1,0,308,0.000088,0,0,0,0
n754,nsta2004a,,nsta2004a,nsta2004a,2,6,1,1,2,0,20,0.000136,1,1,1,2
n755,crucial,,crucial,crucial,2,6,1,1,2,0,20,0.000204,1,1,0,1
n756,component,,component,component,8,1,2,4,6,0,20,0.000609,0,0,0,0
n757,read,,read,read,4,9,1,2,3,0,285,0.000152,7,0,0,0
n758,faced,,faced,faced,4,5,0,2,2,0,310,0.000088,0,0,2,2
n759,alternative,,alternative,alternative,12,16,3,2,5,0,20,0.00039,0,3,2,5
n760,representation,,representation,representation,12,13,2,6,8,0,20,0.000262,8,2,2,4
n761,visible,,visible,visible,2,6,0,1,1,0,311,0.000088,1,0,1,1
n762,various,,various,various,4,13,0,2,2,0,312,0.000088,0,0,1,1
n763,visual,,visual,visual,2,6,1,1,2,0,20,0.000187,3,0,1,1
n764,collect,,collect,collect,30,5,3,1,4,0,1,0.006142,4,7,6,13
n765,promising,,promising,promising,2,3,0,1,1,0,313,0.000088,2,0,1,1
n766,help,,help,help,18,3,4,1,5,0,20,0.000397,2,1,4,5
n767,predict,,predict,predict,52,9,9,3,12,0,20,0.001176,7,0,0,0
n770,overall,,overall,overall,5,15,1,1,2,0,136,0.000107,5,1,2,3
n771,sparks,,sparks,sparks,4,14,0,1,1,0,317,0.000088,4,0,0,0
n772,anchors,,anchors,anchors,4,14,1,1,2,0,316,0.000163,4,0,0,0
n773,want,,want,want,10,16,2,1,3,0,20,0.000219,9,2,3,5
n774,adaptable,,adaptable,adaptable,8,15,1,1,2,0,20,0.00054,5,2,0,2
n775,represent,,represent,represent,12,1,2,1,3,0,20,0.000201,0,0,0,0
n776,emerge,,emerge,emerge,22,1,5,3,8,0,20,0.00045,0,0,0,0
n777,accurate,,accurate,accurate,4,14,1,1,2,0,195,0.000253,5,0,0,0
n778,inaccurate,,inaccurate,inaccurate,4,14,1,1,2,0,194,0.000303,5,0,0,0
n779,critiqued,,critiqued,critiqued,4,18,1,1,2,0,11,0.000239,0,0,0,0
n780,key,,key,key,29,1,8,3,11,0,20,0.001229,0,0,0,0
n781,lpp,,lpp,lpp,10,14,1,1,2,0,20,0.000217,6,0,0,0
n782,system,,system,system,10,14,3,1,4,0,20,0.000493,6,0,0,0
n783,1,,1,1,17,5,3,1,4,0,20,0.000343,5,4,2,6
n784,augmented,,augmented,augmented,4,8,0,1,1,0,318,0.000088,1,0,2,2
n785,vision,,vision,vision,2,12,1,1,2,0,20,0.000108,5,1,0,1
n786,record,,record,record,20,5,2,3,5,0,20,0.000208,4,1,6,7
n787,display,,display,display,6,1,1,3,4,0,20,0.000121,0,0,0,0
n788,location,,location,location,6,9,0,3,3,0,319,0.000088,7,0,0,0
n789,2,,2,2,16,9,3,8,11,0,20,0.000234,7,0,0,0
n790,translate,,translate,translate,4,14,2,2,4,0,20,0.00016,7,0,0,0
n791,motion,,motion,motion,14,14,3,1,4,0,20,0.000324,7,0,0,0
n792,physics,,physics,physics,8,2,0,1,1,0,320,0.000088,1,0,3,3
n793,engine,,engine,engine,2,5,0,1,1,0,321,0.000088,5,0,1,1
n794,sensing,,sensing,sensing,2,5,0,1,1,0,322,0.000088,4,0,1,1
n795,commercially,,commercially,commercially,2,11,0,1,1,0,324,0.000088,4,0,1,1
n796,available,,available,available,2,11,1,1,2,0,323,0.000163,4,1,1,2
n797,track_trace,,track_trace,track_trace,4,14,1,2,3,0,20,0.000363,7,0,0,0
n798,pattern,,pattern,pattern,12,14,2,6,8,0,20,0.000317,7,0,0,0
n799,technology,,technology,technology,8,18,1,4,5,0,34,0.000112,3,0,0,0
n800,kato2006,,kato2006,kato2006,2,18,1,1,2,0,33,0.000112,3,0,0,0
n801,inexpensive,,inexpensive,inexpensive,2,16,0,1,1,0,325,0.000088,0,0,1,1
n802,virtual,,virtual,virtual,2,8,0,1,1,0,326,0.000088,1,0,1,1
n803,12,,12,12,4,18,1,2,3,0,37,0.000255,2,0,0,0
n804,x,,x,x,2,18,1,1,2,0,37,0.000196,2,0,0,0
n805,carpet,,carpet,carpet,2,18,1,1,2,0,36,0.000196,2,0,0,0
n806,front,,front,front,2,18,1,1,2,0,35,0.000255,2,0,0,0
n807,instantly,,instantly,instantly,2,13,0,1,1,0,331,0.000088,3,0,1,1
n808,imported,,imported,imported,2,13,1,1,2,0,330,0.000163,3,1,1,2
n809,microworld,,microworld,microworld,2,12,1,1,2,0,20,0.000108,5,1,1,2
n810,force,,force,force,4,7,1,2,3,0,333,0.000163,6,1,1,2
n811,simulation,,simulation,simulation,7,5,2,3,5,0,20,0.000319,7,2,1,3
n812,animation,,animation,animation,2,12,1,1,2,0,20,0.000108,5,1,1,2
n813,combine,,combine,combine,8,12,1,4,5,0,20,0.00018,5,1,1,2
n814,symbol,,symbol,symbol,2,1,0,1,1,0,334,0.000088,0,0,0,0
n815,marked,,marked,marked,2,2,0,1,1,0,335,0.000088,4,0,1,1
n816,embodied,,embodied,embodied,4,2,1,2,3,0,20,0.00017,3,1,1,2
n817,net,,net,net,2,7,0,1,1,0,336,0.000088,6,0,1,1
n818,game,,game,game,2,7,1,1,2,0,332,0.000157,6,1,1,2
n819,6–8,,6–8,6–8,2,12,1,1,2,0,20,0.000137,3,0,1,1
n820,year,,year,year,16,12,2,8,10,0,20,0.000236,3,2,5,7
n821,interrogate,,interrogate,interrogate,2,1,0,1,1,0,337,0.000088,0,0,0,0
n822,roseberyetal2005,,roseberyetal2005,roseberyetal2005,2,3,0,1,1,0,338,0.000088,2,0,1,1
n823,danish2009,,danish2009,danish2009,2,14,0,1,1,0,339,0.000088,4,0,0,0
n824,skits,,skits,skits,2,2,1,1,2,0,20,0.000168,3,1,0,1
n825,enact,,enact,enact,4,13,0,2,2,0,340,0.000088,0,0,1,1
n826,leverage,,leverage,leverage,2,13,0,1,1,0,341,0.000088,3,0,1,1
n827,kind,,kind,kind,14,9,4,7,11,0,20,0.000451,6,0,0,0
n828,colella2000,,colella2000,colella2000,2,3,1,1,2,0,20,0.000178,6,0,1,1
n829,try,,try,try,20,7,2,1,3,0,20,0.001125,0,3,3,6
n830,desired,,desired,desired,2,4,0,1,1,0,344,0.000088,6,0,1,1
n831,resultand,,resultand,resultand,2,4,1,1,2,0,343,0.000163,6,1,1,2
n832,affect,,affect,affect,2,4,1,1,2,0,342,0.000226,6,1,1,2
n833,type,,type,type,12,13,4,1,5,0,20,0.000351,4,0,2,2
n834,explicit,,explicit,explicit,6,10,1,3,4,0,20,0.000136,5,0,1,1
n835,rules,,rules,rules,2,5,0,1,1,0,346,0.000088,7,0,1,1
n836,underlie,,underlie,underlie,2,5,1,1,2,0,345,0.000163,7,1,1,2
n837,multi,,multi,multi,4,12,0,2,2,0,348,0.000088,1,0,1,1
n838,faceted,,faceted,faceted,2,12,1,1,2,0,347,0.000125,1,1,1,2
n839,aim,,aim,aim,14,3,5,1,6,0,20,0.000579,5,1,2,3
n840,choice,,choice,choice,6,1,1,3,4,0,350,0.000194,0,0,0,0
n841,change,,change,change,8,13,0,4,4,0,351,0.000088,6,0,2,2
n842,water,,water,water,10,13,4,5,9,0,20,0.000309,6,3,1,4
n843,single,,single,single,8,7,3,4,7,0,20,0.000255,5,3,1,4
n844,garritz2012,,garritz2012,garritz2012,2,4,0,1,1,0,353,0.000088,5,0,1,1
n845,newmanetal2004,,newmanetal2004,newmanetal2004,2,4,1,1,2,0,352,0.000163,5,1,1,2
n846,characterized,,characterized,characterized,4,4,1,2,3,0,20,0.000121,5,1,2,3
n847,progression,,progression,progression,10,3,0,5,5,0,354,0.000088,15,0,2,2
n848,already,,already,already,4,16,2,1,3,0,20,0.000151,9,0,2,2
n849,interacademy,,interacademy,interacademy,2,15,0,1,1,0,358,0.000088,6,0,1,1
n850,partnership,,partnership,partnership,2,15,1,1,2,0,357,0.000163,6,1,1,2
n851,iap2010p19,,iap2010p19,iap2010p19,2,15,1,1,2,0,356,0.000226,6,1,1,2
n852,among,,among,among,6,15,1,3,4,0,355,0.00028,6,1,1,2
n853,perspective,,perspective,perspective,8,1,2,4,6,0,20,0.000164,0,0,0,0
n854,requires,,requires,requires,8,16,0,4,4,0,359,0.000088,3,0,1,1
n855,caamano2012,,caamano2012,caamano2012,2,1,0,1,1,0,362,0.000088,0,0,0,0
n856,criadogarcíacarmona2011,,criadogarcíacarmona2011,criadogarcíacarmona2011,2,1,1,1,2,0,361,0.000163,0,0,0,0
n857,harlen2014,,harlen2014,harlen2014,3,1,1,1,2,0,360,0.000226,0,0,0,0
n858,score2013,,score2013,score2013,2,13,0,1,1,0,363,0.000088,6,0,1,1
n859,hodson2014,,hodson2014,hodson2014,2,2,0,1,1,0,364,0.000088,4,0,1,1
n860,exa,,exa,exa,2,2,1,1,2,0,20,0.000214,4,1,0,1
n861,agree,,agree,agree,6,1,3,1,4,0,20,0.000204,0,0,0,0
n862,ledermanetal2014,,ledermanetal2014,ledermanetal2014,2,1,1,1,2,0,20,0.000136,0,0,0,0
n863,hypothesis,,hypothesis,hypothesis,46,13,12,1,13,0,20,0.001825,4,10,3,13
n864,ii,,ii,ii,4,7,0,2,2,0,365,0.000088,5,0,1,1
n865,iii,,iii,iii,4,1,0,2,2,0,366,0.000088,0,0,0,0
n866,pose,,pose,pose,8,4,0,4,4,0,368,0.000088,2,0,2,2
n867,iv,,iv,iv,2,6,1,1,2,0,367,0.000107,2,0,1,1
n868,v,,v,v,2,1,0,1,1,0,369,0.000088,0,0,0,0
n869,vi,,vi,vi,2,16,0,1,1,0,370,0.000088,1,0,1,1
n870,must,,must,must,8,11,0,4,4,0,371,0.000088,7,0,1,1
n871,vii,,vii,vii,2,1,1,1,2,0,20,0.000115,0,0,0,0
n872,number,,number,number,8,16,2,4,6,0,20,0.000123,5,2,2,4
n873,image,,image,image,2,1,0,1,1,0,373,0.000088,0,0,0,0
n874,etc,,etc,etc,2,1,1,1,2,0,372,0.000163,0,0,0,0
n875,viii,,viii,viii,2,13,0,1,1,0,374,0.000088,1,0,1,1
n876,mentioned,,mentioned,mentioned,2,7,1,1,2,0,20,0.000465,1,1,0,1
n877,even,,even,even,9,4,1,5,6,0,20,0.000131,5,1,2,3
n878,tentative,,tentative,tentative,2,1,0,1,1,0,375,0.000088,0,0,0,0
n879,three,,three,three,17,8,2,2,4,0,20,0.000193,4,1,4,5
n880,distinguish,,distinguish,distinguish,4,9,1,2,3,0,20,0.000181,6,0,0,0
n881,guisasolaetal2006,,guisasolaetal2006,guisasolaetal2006,2,13,1,1,2,0,20,0.000165,4,0,1,1
n882,stating,,stating,stating,2,17,0,1,1,0,376,0.000088,1,0,1,1
n883,yet,,yet,yet,8,17,3,4,7,0,20,0.000264,1,2,0,2
n884,event,,event,event,6,5,1,3,4,0,378,0.000226,2,1,2,3
n885,speculating,,speculating,speculating,2,7,0,1,1,0,379,0.000088,0,0,1,1
n886,deductive,,deductive,deductive,2,16,0,1,1,0,380,0.000088,3,0,1,1
n887,trueprocedural,,trueprocedural,trueprocedural,2,13,0,1,1,0,381,0.000088,4,0,1,1
n888,measurement,,measurement,measurement,14,5,2,7,9,0,20,0.000234,4,1,5,6
n889,procedure,,procedure,procedure,20,5,3,1,4,0,2,0.000174,4,1,2,3
n890,indicate,,indicate,indicate,4,12,0,2,2,0,383,0.000088,0,0,1,1
n891,obtain,,obtain,obtain,12,7,1,1,2,0,20,0.000108,1,0,2,2
n892,beforehand,,beforehand,beforehand,2,10,1,1,2,0,20,0.000117,3,0,1,1
n893,either,,either,either,8,7,0,1,1,0,384,0.000088,0,0,3,3
n894,organization,,organization,organization,4,1,2,2,4,0,20,0.00019,0,0,0,0
n895,fsls,,fsls,fsls,1,18,0,1,1,0,39,0.000088,4,0,0,0
n896,ultimate,,ultimate,ultimate,4,18,2,1,3,0,38,0.000211,4,0,0,0
n897,fsl,,fsl,fsl,4,8,0,2,2,0,386,0.000088,2,0,1,1
n898,openfocused,,openfocused,openfocused,4,3,0,1,1,0,387,0.000088,2,0,2,2
n899,engage–explore–reflect,,engage–explore–reflect,engage–explore–reflect,2,1,1,1,2,0,164,0.00012,0,0,0,0
n900,eer,,eer,eer,6,1,1,1,2,0,163,0.00019,0,0,0,0
n901,talk,,talk,talk,12,1,3,6,9,0,20,0.000156,0,0,0,0
n902,tips,,tips,tips,2,1,1,1,2,0,20,0.00011,0,0,0,0
n903,depicted,,depicted,depicted,2,5,0,1,1,0,388,0.000088,5,0,1,1
n904,figure,,figure,figure,6,5,3,1,4,0,20,0.000238,5,1,2,3
n905,illustrate,,illustrate,illustrate,4,1,1,2,3,0,389,0.000163,0,0,0,0
n906,iterative,,iterative,iterative,4,16,0,2,2,0,391,0.000088,3,0,2,2
n907,stepbystep,,stepbystep,stepbystep,4,20,1,2,3,0,20,0.000143,0,1,0,1
n908,spiraling,,spiraling,spiraling,2,15,0,1,1,0,393,0.000088,1,0,1,1
n909,dynamic,,dynamic,dynamic,4,15,2,2,4,0,392,0.0002,1,2,1,3
n910,integrates,,integrates,integrates,2,1,1,1,2,0,162,0.00012,0,0,0,0
n911,unstructured,,unstructured,unstructured,2,3,0,1,1,0,394,0.000088,4,0,1,1
n912,jumpstarting,,jumpstarting,jumpstarting,2,13,1,1,2,0,256,0.000125,5,1,0,1
n913,b,,b,b,8,6,0,4,4,0,395,0.000088,5,0,2,2
n914,responsive,,responsive,responsive,2,3,0,1,1,0,396,0.000088,2,0,1,1
n915,simplified,,simplified,simplified,2,14,0,1,1,0,397,0.000088,4,0,0,0
n916,cycles,,cycles,cycles,2,16,1,1,2,0,390,0.000125,3,1,0,1
n917,contextualizes,,contextualizes,contextualizes,2,1,0,1,1,0,398,0.000088,0,0,0,0
n918,efforts,,efforts,efforts,2,16,0,1,1,0,399,0.000088,1,0,1,1
n919,invite,,invite,invite,2,9,0,1,1,0,400,0.000088,7,0,0,0
n920,explicated,,explicated,explicated,2,12,0,1,1,0,402,0.000088,3,0,1,1
n921,upcoming,,upcoming,upcoming,2,12,1,1,2,0,401,0.000163,3,1,1,2
n922,area,,area,area,8,7,2,4,6,0,20,0.000263,9,1,3,4
n923,menmuiradams1997processes,,menmuiradams1997processes,menmuiradams1997processes,2,7,1,1,2,0,20,0.000144,9,1,0,1
n924,inconjunction,,inconjunction,inconjunction,2,1,0,1,1,0,403,0.000088,0,0,0,0
n925,mathematical,,mathematical,mathematical,37,1,6,1,7,0,20,0.000475,0,0,0,0
n926,epstein2007,,epstein2007,epstein2007,4,9,0,2,2,0,409,0.000088,3,0,0,0
n927,french2004,,french2004,french2004,9,9,2,1,3,0,408,0.000163,3,0,0,0
n928,gerdeetal2013,,gerdeetal2013,gerdeetal2013,10,9,2,5,7,0,407,0.000263,3,0,0,0
n929,menmuiradams1997,,menmuiradams1997,menmuiradams1997,2,9,1,1,2,0,406,0.000133,3,0,0,0
n930,afford,,afford,afford,2,9,0,1,1,0,410,0.000088,1,0,0,0
n931,fascination,,fascination,fascination,4,19,1,2,3,0,86,0.000113,0,0,1,1
n932,rich,,rich,rich,4,13,0,2,2,0,411,0.000088,8,0,1,1
n933,just,,just,just,16,1,5,8,13,0,20,0.000288,0,0,0,0
n934,static,,static,static,4,13,2,2,4,0,20,0.000227,1,2,1,3
n935,prescribed,,prescribed,prescribed,6,13,1,3,4,0,20,0.000184,1,1,1,2
n936,big,,big,big,6,14,2,1,3,0,20,0.000181,2,0,0,0
n937,gelmanbrenneman2012,,gelmanbrenneman2012,gelmanbrenneman2012,4,9,1,2,3,0,413,0.000163,3,0,0,0
n938,wasserman2015,,wasserman2015,wasserman2015,2,9,1,1,2,0,412,0.000157,3,0,0,0
n939,gelmanetal2010,,gelmanetal2010,gelmanetal2010,2,9,0,1,1,0,414,0.000088,3,0,0,0
n940,greenfieldetal2009,,greenfieldetal2009,greenfieldetal2009,5,9,3,2,5,0,405,0.000276,3,0,0,0
n941,inanetal2010,,inanetal2010,inanetal2010,7,9,2,4,6,0,404,0.00025,3,0,0,0
n942,apply,,apply,apply,12,15,2,1,3,0,415,0.000209,2,2,2,4
n943,gelmanbrenneman2004,,gelmanbrenneman2004,gelmanbrenneman2004,2,16,0,1,1,0,416,0.000088,3,0,1,1
n944,linking,,linking,linking,4,6,1,2,3,0,20,0.000141,6,1,1,2
n945,extant,,extant,extant,2,6,1,1,2,0,20,0.000148,6,1,0,1
n946,bjorklund2011,,bjorklund2011,bjorklund2011,2,9,0,1,1,0,417,0.000088,3,0,0,0
n947,paper,,paper,paper,5,1,1,3,4,0,20,0.000135,0,0,0,0
n948,case,,case,case,6,4,2,1,3,0,20,0.000151,3,0,2,2
n949,implement,,implement,implement,4,8,0,2,2,0,419,0.000088,3,0,2,2
n950,forensic,,forensic,forensic,2,8,1,1,2,0,418,0.000125,3,1,0,1
n951,fouryearold,,fouryearold,fouryearold,4,18,0,2,2,0,40,0.000088,4,0,0,0
n952,participant,,participant,participant,11,1,0,1,1,0,421,0.000088,0,0,0,0
n953,platform,,platform,platform,6,17,1,3,4,0,20,0.000258,3,1,1,2
n954,prepare,,prepare,prepare,4,4,0,2,2,0,422,0.000088,2,0,1,1
n955,hackling2007,,hackling2007,hackling2007,4,1,1,2,3,0,157,0.000117,0,0,0,0
n956,manipulation,,manipulation,manipulation,8,8,2,1,3,0,20,0.00054,0,1,2,3
n957,gain,,gain,gain,14,13,2,7,9,0,20,0.000152,3,1,2,3
n958,heart,,heart,heart,4,1,1,2,3,0,156,0.000138,0,0,0,0
n959,crawford2009,,crawford2009,crawford2009,2,3,0,1,1,0,423,0.000088,3,0,1,1
n960,excitement,,excitement,excitement,2,6,0,1,1,0,424,0.000088,0,0,1,1
n961,crawford2007,,crawford2007,crawford2007,4,1,1,2,3,0,155,0.000117,0,0,0,0
n962,appears,,appears,appears,4,6,1,2,3,0,20,0.000129,6,0,2,2
n963,hackling2005,,hackling2005,hackling2005,4,1,1,1,2,0,20,0.000465,0,0,0,0
n964,hedges2000,,hedges2000,hedges2000,2,4,0,1,1,0,425,0.000088,1,0,1,1
n965,acknowledge,,acknowledge,acknowledge,8,8,1,1,2,0,20,0.000138,5,0,2,2
n966,agents,,agents,agents,2,16,0,1,1,0,426,0.000088,0,0,1,1
n967,hedges2000p18,,hedges2000p18,hedges2000p18,2,15,0,1,1,0,427,0.000088,1,0,1,1
n968,issue,,issue,issue,6,8,1,3,4,0,20,0.000197,4,1,1,2
n969,select,,select,select,14,5,4,1,5,0,20,0.000552,5,4,2,6
n970,samarapungavanetal2008,,samarapungavanetal2008,samarapungavanetal2008,10,9,2,5,7,0,20,0.000241,7,0,0,0
n971,commented,,commented,commented,2,14,1,1,2,0,20,0.000115,6,0,0,0
n972,universal,,universal,universal,2,7,0,1,1,0,431,0.000088,7,0,1,1
n973,novices,,novices,novices,2,7,1,1,2,0,430,0.000163,7,1,1,2
n974,p903,,p903,p903,2,7,1,1,2,0,429,0.000226,7,1,1,2
n975,lacking,,lacking,lacking,2,7,1,1,2,0,428,0.00028,7,1,1,2
n976,discipline,,discipline,discipline,6,6,1,3,4,0,20,0.00097,2,2,2,4
n977,discourse,,discourse,discourse,30,13,8,1,9,0,20,0.002237,0,6,4,10
n978,assisting,,assisting,assisting,8,3,1,1,2,0,20,0.000182,8,2,3,5
n979,better,,better,better,10,1,2,1,3,0,20,0.000197,0,0,0,0
n980,outcome,,outcome,outcome,6,4,0,3,3,0,432,0.000088,2,0,1,1
n981,examine,,examine,examine,16,9,5,1,6,0,20,0.000728,1,0,0,0
n982,kindergarten,,kindergarten,kindergarten,14,12,2,2,4,0,382,0.000263,0,2,2,4
n983,monarch,,monarch,monarch,2,16,0,1,1,0,434,0.000088,7,0,1,1
n984,butterfly,,butterfly,butterfly,2,16,1,1,2,0,433,0.000163,7,1,1,2
n985,revise,,revise,revise,12,14,3,6,9,0,20,0.000257,7,0,0,0
n986,portfolios,,portfolios,portfolios,2,3,0,1,1,0,435,0.000088,3,0,1,1
n987,peterson,,peterson,peterson,2,9,0,1,1,0,437,0.000088,1,0,0,0
n988,french2008,,french2008,french2008,2,9,1,1,2,0,436,0.000163,1,0,0,0
n989,color,,color,color,2,5,1,1,2,0,10,0.000117,6,1,1,2
n990,mixing,,mixing,mixing,2,5,1,1,2,0,9,0.000187,6,1,1,2
n991,investigators,,investigators,investigators,4,15,0,2,2,0,438,0.000088,1,0,1,1
n992,demonstrate,,demonstrate,demonstrate,4,3,1,2,3,0,20,0.000117,4,1,1,2
n993,literate,,literate,literate,6,6,1,3,4,0,20,0.000156,6,1,2,3
n994,curious,,curious,curious,4,7,1,2,3,0,20,0.000116,10,1,1,2
n995,surround,,surround,surround,5,7,0,2,2,0,439,0.000088,1,0,1,1
n996,concrete,,concrete,concrete,6,7,0,3,3,0,440,0.000088,1,0,1,1
n998,cepnietal2006,,cepnietal2006,cepnietal2006,2,16,1,1,2,0,20,0.000148,3,0,1,1
n999,divided,,divided,divided,2,8,0,1,1,0,441,0.000088,4,0,1,1
n1000,cause,,cause,cause,4,12,0,2,2,0,444,0.000088,7,0,1,1
n1001,since,,since,since,2,11,1,1,2,0,20,0.000106,5,0,1,1
n1002,birth,,birth,birth,2,11,1,1,2,0,20,0.000178,5,1,1,2
n1003,estimation,,estimation,estimation,2,14,0,1,1,0,445,0.000088,3,0,0,0
n1004,howejones1998,,howejones1998,howejones1998,2,13,0,1,1,0,446,0.000088,4,0,1,1
n1005,check,,check,check,2,16,0,1,1,0,447,0.000088,3,0,1,1
n1006,lind2000,,lind2000,lind2000,2,2,1,1,2,0,20,0.000119,0,1,0,1
n1007,kefietal2013,,kefietal2013,kefietal2013,2,16,1,1,2,0,20,0.000148,8,0,1,1
n1008,without,,without,without,4,2,1,2,3,0,448,0.000226,5,1,2,3
n1009,sip,,sip,sip,1,1,0,1,1,0,449,0.000088,0,0,0,0
n1010,basis,,basis,basis,16,15,2,1,3,0,20,0.000335,7,3,0,3
n1011,correspond,,correspond,correspond,6,14,2,1,3,0,20,0.000759,3,0,0,0
n1012,hacking19921995,,hacking19921995,hacking19921995,2,19,0,1,1,0,450,0.000088,1,0,1,1
n1013,map,,map,map,4,19,2,2,4,0,20,0.000174,1,1,2,3
n1014,laboratory,,laboratory,laboratory,4,19,2,2,4,0,20,0.000203,1,2,0,2
n1015,subjecting,,subjecting,subjecting,2,1,1,1,2,0,152,0.000103,0,0,0,0
n1016,systematic,,systematic,systematic,8,1,3,4,7,0,20,0.000393,0,0,0,0
n1017,bottomup,,bottomup,bottomup,2,5,1,1,2,0,19,0.000171,4,0,1,1
n1018,entity,,entity,entity,8,7,2,1,3,0,20,0.000229,8,2,2,4
n1019,internal,,internal,internal,4,7,1,1,2,0,20,0.000283,8,2,0,2
n1020,hackings,,hackings,hackings,2,1,0,1,1,0,451,0.000088,0,0,0,0
n1021,psillos,,psillos,psillos,2,16,1,1,2,0,161,0.00012,2,0,1,1
n1022,tselfes,,tselfes,tselfes,2,16,1,1,2,0,160,0.00019,2,1,1,2
n1023,kariotoglou2004,,kariotoglou2004,kariotoglou2004,2,16,1,1,2,0,159,0.000249,2,1,1,2
n1024,peters2006,,peters2006,peters2006,2,5,0,1,1,0,452,0.000088,3,0,1,1
n1025,improve,,improve,improve,4,1,0,1,1,0,453,0.000088,0,0,0,0
n1026,hogan2000,,hogan2000,hogan2000,4,14,0,1,1,0,455,0.000088,2,0,0,0
n1027,hoganmaglienti2001,,hoganmaglienti2001,hoganmaglienti2001,4,14,1,2,3,0,454,0.000163,2,0,0,0
n1028,deboo2000,,deboo2000,deboo2000,2,7,1,1,2,0,20,0.000156,9,0,1,1
n1029,lind1999,,lind1999,lind1999,7,7,3,3,6,0,20,0.000667,9,2,2,4
n1030,novak1977,,novak1977,novak1977,2,7,1,1,2,0,20,0.000277,9,1,1,2
n1031,overwhelmingly,,overwhelmingly,overwhelmingly,4,9,1,2,3,0,20,0.000228,2,0,0,0
n1032,nses,,nses,nses,6,3,2,3,5,0,245,0.000173,4,2,2,4
n1033,american,,american,american,2,3,1,1,2,0,244,0.000137,4,1,0,1
n1034,council1996,,council1996,council1996,2,1,0,1,1,0,456,0.000088,0,0,0,0
n1035,bredekampcopple1997,,bredekampcopple1997,bredekampcopple1997,2,3,0,1,1,0,457,0.000088,2,0,1,1
n1036,enactment,,enactment,enactment,9,11,3,1,4,0,20,0.000267,5,2,2,4
n1037,techniques,,techniques,techniques,4,5,0,2,2,0,458,0.000088,4,0,1,1
n1038,coordination,,coordination,coordination,2,14,0,1,1,0,459,0.000088,2,0,0,0
n1039,rely,,rely,rely,4,9,1,2,3,0,20,0.00016,1,0,0,0
n1040,tend,,tend,tend,4,11,1,2,3,0,27,0.000125,5,1,1,2
n1041,mind,,mind,mind,2,11,1,1,2,0,26,0.000141,5,1,1,2
n1042,speak,,speak,speak,4,11,1,2,3,0,25,0.000208,5,1,1,2
n1043,emphasize,,emphasize,emphasize,19,12,3,10,13,0,20,0.000697,8,2,5,7
n1044,eshachfried2005,,eshachfried2005,eshachfried2005,4,17,1,2,3,0,460,0.000163,1,1,1,2
n1045,harlen1996,,harlen1996,harlen1996,2,14,0,1,1,0,462,0.000088,2,0,0,0
n1046,lind,,lind,lind,2,14,1,1,2,0,461,0.000163,2,0,0,0
n1047,nses1996,,nses1996,nses1996,1,7,1,0,1,0,0,0.000277,9,1,0,1
n1048,advance,,advance,advance,4,3,1,2,3,0,149,0.000107,5,0,2,2
n1049,whose,,whose,whose,4,3,2,2,4,0,147,0.000161,5,1,1,2
n1050,fleer1993,,fleer1993,fleer1993,2,15,0,1,1,0,463,0.000088,4,0,1,1
n1051,depth,,depth,depth,4,2,1,2,3,0,20,0.000129,2,1,0,1
n1052,bredekampcople1997,,bredekampcople1997,bredekampcople1997,2,17,0,1,1,0,464,0.000088,1,0,1,1
n1053,hacking1992,,hacking1992,hacking1992,2,7,1,1,2,0,20,0.000148,8,0,1,1
n1055,occur,,occur,occur,4,9,0,2,2,0,465,0.000088,2,0,0,0
n1056,bridge,,bridge,bridge,4,1,1,2,3,0,466,0.000113,0,0,0,0
n1057,current,,current,current,6,1,2,1,3,0,20,0.00021,0,0,0,0
n1060,ermeling2010,,ermeling2010,ermeling2010,4,9,0,2,2,0,469,0.000088,3,0,0,0
n1061,inquisitiveness,,inquisitiveness,inquisitiveness,2,3,0,1,1,0,470,0.000088,2,0,1,1
n1063,impact,,impact,impact,4,11,1,2,3,0,471,0.000163,1,1,1,2
n1064,let,,let,let,4,11,2,2,4,0,20,0.000283,6,1,1,2
n1065,seven,,seven,seven,2,4,0,1,1,0,472,0.000088,2,0,1,1
n1066,four,,four,four,8,5,2,4,6,0,20,0.000149,6,2,1,3
n1067,3,,3,3,12,2,1,6,7,0,20,0.000177,6,1,1,2
n1068,4,,4,4,6,11,0,3,3,0,473,0.000088,4,0,1,1
n1069,conjunction,,conjunction,conjunction,2,1,0,1,1,0,475,0.000088,0,0,0,0
n1070,multiday,,multiday,multiday,2,1,1,1,2,0,474,0.000163,0,0,0,0
n1071,lens,,lens,lens,2,1,0,1,1,0,476,0.000088,0,0,0,0
n1072,beyond,,beyond,beyond,12,12,4,6,10,0,20,0.000386,4,3,2,5
n1073,p21,,p21,p21,2,3,0,1,1,0,477,0.000088,4,0,1,1
n1074,assert,,assert,assert,2,3,1,1,2,0,243,0.000137,4,1,1,2
n1076,eickreed2002,,eickreed2002,eickreed2002,2,14,1,1,2,0,20,0.000547,2,0,0,0
n1077,bianchinicolburn2000,,bianchinicolburn2000,bianchinicolburn2000,2,16,0,1,1,0,479,0.000088,6,0,1,1
n1078,lambert2007,,lambert2007,lambert2007,2,16,1,1,2,0,478,0.000163,6,1,1,2
n1079,judge,,judge,judge,6,5,0,3,3,0,480,0.000088,5,0,2,2
n1080,p389,,p389,p389,2,1,1,1,2,0,41,0.000123,0,0,0,0
n1081,nrc1996,,nrc1996,nrc1996,6,5,1,3,4,0,154,0.000138,0,0,2,2
n1082,bodzinbeerer2003,,bodzinbeerer2003,bodzinbeerer2003,2,5,1,1,2,0,153,0.000127,0,1,0,1
n1083,rubric,,rubric,rubric,2,14,0,1,1,0,482,0.000088,6,0,0,0
n1084,stir,,stir,stir,2,14,1,1,2,0,481,0.000163,6,0,0,0
n1085,rate,,rate,rate,2,1,0,1,1,0,483,0.000088,0,0,0,0
n1086,six,,six,six,4,5,0,2,2,0,484,0.000088,1,0,1,1
n1087,prospective,,prospective,prospective,2,4,0,1,1,0,485,0.000088,1,0,1,1
n1088,windschitl2003,,windschitl2003,windschitl2003,2,16,0,1,1,0,486,0.000088,6,0,1,1
n1089,cookbook,,cookbook,cookbook,2,19,0,1,1,0,487,0.000088,1,0,1,1
n1090,verify,,verify,verify,2,16,0,1,1,0,488,0.000088,9,0,1,1
n1091,unknown,,unknown,unknown,4,5,0,2,2,0,489,0.000088,0,0,2,2
n1093,hand,,hand,hand,10,13,3,5,8,0,20,0.000437,1,0,2,2
n1094,matching,,matching,matching,2,12,1,1,2,0,20,0.000149,6,1,0,1
n1095,along,,along,along,8,8,0,4,4,0,492,0.000088,2,0,3,3
n1096,trundlesackes2012,,trundlesackes2012,trundlesackes2012,2,6,1,1,2,0,20,0.000152,7,1,0,1
n1097,appleton2008,,appleton2008,appleton2008,4,1,0,2,2,0,493,0.000088,0,0,0,0
n1098,unproductive,,unproductive,unproductive,2,12,0,1,1,0,494,0.000088,2,0,1,1
n1099,low,,low,low,4,4,1,2,3,0,20,0.000118,7,0,2,2
n1100,selfregulation,,selfregulation,selfregulation,2,4,1,1,2,0,20,0.000138,7,1,1,2
n1101,capacities,,capacities,capacities,2,4,1,1,2,0,20,0.000205,7,1,1,2
n1102,persistent,,persistent,persistent,2,4,1,1,2,0,20,0.000262,7,1,1,2
n1103,misconceptions,,misconceptions,misconceptions,4,4,1,2,3,0,20,0.000311,7,1,0,1
n1104,traditional,,traditional,traditional,6,13,2,3,5,0,20,0.000217,1,1,2,3
n1105,fail,,fail,fail,2,8,1,1,2,0,20,0.000109,7,1,1,2
n1106,restructuring,,restructuring,restructuring,8,3,0,4,4,0,496,0.000088,15,0,2,2
n1107,duittreagust2003,,duittreagust2003,duittreagust2003,2,4,0,1,1,0,497,0.000088,1,0,1,1
n1108,holliday2006,,holliday2006,holliday2006,3,4,2,1,3,0,20,0.000223,1,1,1,2
n1109,intended,,intended,intended,6,3,1,3,4,0,230,0.00017,0,1,2,3
n1110,feature,,feature,feature,16,8,5,1,6,0,20,0.000655,4,6,2,8
n1111,target,,target,target,12,2,2,2,4,0,20,0.000188,1,2,4,6
n1112,threestep,,threestep,threestep,6,6,1,1,2,0,498,0.000163,4,1,2,3
n1113,responsibility,,responsibility,responsibility,2,1,0,1,1,0,499,0.000088,0,0,0,0
n1114,sensitive,,sensitive,sensitive,2,8,0,1,1,0,500,0.000088,4,0,1,1
n1115,ensure,,ensure,ensure,4,3,1,2,3,0,231,0.000194,0,1,2,3
n1116,float,,float,float,14,13,4,1,5,0,20,0.000805,6,4,5,9
n1117,sink,,sink,sink,11,13,1,5,6,0,20,0.000773,6,5,2,7
n1118,usually,,usually,usually,2,11,1,1,2,0,20,0.000219,8,0,1,1
n1119,salient,,salient,salient,2,8,0,1,1,0,501,0.000088,4,0,1,1
n1120,weight,,weight,weight,4,20,1,1,2,0,20,0.000193,3,2,2,4
n1121,size,,size,size,4,20,1,2,3,0,20,0.000252,3,2,0,2
n1122,properties,,properties,properties,6,9,0,3,3,0,502,0.000088,4,0,0,0
n1123,samematerial,,samematerial,samematerial,2,13,0,1,1,0,503,0.000088,6,0,1,1
n1124,verbal,,verbal,verbal,6,10,1,3,4,0,20,0.000126,5,1,2,3
n1125,nonverbally,,nonverbally,nonverbally,2,10,1,1,2,0,20,0.000124,5,1,0,1
n1126,invitation,,invitation,invitation,2,19,1,1,2,0,20,0.00015,0,1,0,1
n1127,namygentner2002,,namygentner2002,namygentner2002,2,1,0,1,1,0,504,0.000088,0,0,0,0
n1128,stimulate,,stimulate,stimulate,12,3,4,1,5,0,20,0.000354,2,1,2,3
n1129,expectations,,expectations,expectations,6,7,1,3,4,0,20,0.000199,3,1,1,2
n1130,justify,,justify,justify,4,16,1,2,3,0,20,0.000673,7,2,1,3
n1131,bybee2006,,bybee2006,bybee2006,2,2,0,1,1,0,507,0.000088,0,0,1,1
n1132,molleretal2012,,molleretal2012,molleretal2012,2,2,1,1,2,0,506,0.000163,0,1,1,2
n1133,wisersmith2008,,wisersmith2008,wisersmith2008,2,2,1,1,2,0,505,0.000226,0,1,1,2
n1134,plastic,,plastic,plastic,8,12,2,4,6,0,20,0.000202,6,0,3,3
n1135,adjective,,adjective,adjective,2,12,1,1,2,0,20,0.000131,6,1,0,1
n1136,shininess,,shininess,shininess,2,12,1,1,2,0,20,0.000131,6,1,1,2
n1137,lightness,,lightness,lightness,2,12,1,1,2,0,20,0.000199,6,1,1,2
n1138,p209,,p209,p209,2,12,1,1,2,0,20,0.000197,6,1,1,2
n1139,grammatical,,grammatical,grammatical,2,12,1,1,2,0,20,0.000255,6,1,0,1
n1140,opposed,,opposed,opposed,2,12,1,1,2,0,20,0.000131,6,1,1,2
n1141,cup,,cup,cup,2,12,1,1,2,0,20,0.000199,6,1,0,1
n1142,attention,,attention,attention,2,8,0,1,1,0,508,0.000088,0,0,1,1
n1143,detect,,detect,detect,8,6,3,4,7,0,20,0.000253,0,2,3,5
n1144,appear,,appear,appear,2,6,1,1,2,0,20,0.000135,4,1,0,1
n1145,concern,,concern,concern,10,8,1,5,6,0,20,0.000644,4,2,3,5
n1146,solid,,solid,solid,2,13,0,1,1,0,509,0.000088,6,0,1,1
n1147,put,,put,put,4,1,1,2,3,0,20,0.000547,0,0,0,0
n1148,problemsolving,,problemsolving,problemsolving,4,4,0,2,2,0,510,0.000088,0,0,2,2
n1149,hmelosilver2006authentic,,hmelosilver2006authentic,hmelosilver2006authentic,2,6,0,1,1,0,511,0.000088,0,0,1,1
n1150,pintrich,,pintrich,pintrich,2,12,0,1,1,0,513,0.000088,0,0,1,1
n1151,marxboyle1993,,marxboyle1993,marxboyle1993,2,12,1,1,2,0,512,0.000163,0,1,1,2
n1152,mayerwittrock2006,,mayerwittrock2006,mayerwittrock2006,2,3,0,1,1,0,514,0.000088,2,0,1,1
n1153,linneylon2006,,linneylon2006,linneylon2006,2,4,1,1,2,0,495,0.000107,0,0,1,1
n1154,contextual,,contextual,contextual,4,6,1,2,3,0,20,0.000118,0,0,1,1
n1155,avoid,,avoid,avoid,2,8,0,1,1,0,515,0.000088,3,0,1,1
n1156,unable,,unable,unable,2,12,0,1,1,0,516,0.000088,8,0,1,1
n1157,fruitful,,fruitful,fruitful,2,3,0,1,1,0,518,0.000088,9,0,1,1
n1158,leave,,leave,leave,2,3,1,1,2,0,517,0.000163,9,1,1,2
n1159,organise,,organise,organise,12,1,2,1,3,0,20,0.000174,0,0,0,0
n1160,schiefelepekrun1996,,schiefelepekrun1996,schiefelepekrun1996,2,3,1,1,2,0,232,0.000125,0,1,1,2
n1161,indeed,,indeed,indeed,2,14,1,1,2,0,20,0.000133,7,0,0,0
n1162,selfreliant,,selfreliant,selfreliant,2,14,0,1,1,0,519,0.000088,6,0,0,0
n1163,hiemstra2000,,hiemstra2000,hiemstra2000,2,6,0,1,1,0,520,0.000088,4,0,1,1
n1164,bscs,,bscs,bscs,2,14,0,1,1,0,521,0.000088,4,0,0,0
n1165,motivation,,motivation,motivation,6,3,1,3,4,0,20,0.000144,15,0,2,2
n1166,groupconcerning,,groupconcerning,groupconcerning,2,1,1,1,2,0,20,0.000105,0,0,0,0
n1167,capability,,capability,capability,8,8,0,4,4,0,523,0.000088,5,0,2,2
n1168,coneziofrench2002,,coneziofrench2002,coneziofrench2002,2,6,0,1,1,0,524,0.000088,7,0,1,1
n1169,executive,,executive,executive,2,6,1,1,2,0,20,0.000131,7,1,0,1
n1170,garon,,garon,garon,2,19,1,1,2,0,20,0.00015,2,1,1,2
n1171,brysonsmith2008,,brysonsmith2008,brysonsmith2008,2,19,1,1,2,0,20,0.000216,2,1,1,2
n1172,operation,,operation,operation,2,19,1,1,2,0,20,0.000271,2,1,0,1
n1173,fading,,fading,fading,2,5,0,1,1,0,526,0.000088,7,0,1,1
n1174,aids,,aids,aids,2,5,1,1,2,0,525,0.000163,7,1,1,2
n1175,lepperetal1997,,lepperetal1997,lepperetal1997,2,10,0,1,1,0,527,0.000088,0,0,1,1
n1176,kuhn2009,,kuhn2009,kuhn2009,2,4,0,1,1,0,528,0.000088,1,0,1,1
n1177,mistakes,,mistakes,mistakes,4,9,1,2,3,0,172,0.000102,2,0,0,0
n1179,experiential,,experiential,experiential,12,4,4,1,5,0,20,0.000383,7,2,6,8
n1180,oversimplified,,oversimplified,oversimplified,2,8,1,1,2,0,20,0.000109,3,1,0,1
n1181,breunig2008,,breunig2008,breunig2008,2,1,0,1,1,0,530,0.000088,0,0,0,0
n1182,roberts2011,,roberts2011,roberts2011,2,1,1,1,2,0,529,0.000163,0,0,0,0
n1183,founders,,founders,founders,2,4,0,1,1,0,531,0.000088,7,0,1,1
n1184,belief,,belief,belief,4,17,0,2,2,0,534,0.000088,5,0,1,1
n1185,isolation,,isolation,isolation,2,12,0,1,1,0,535,0.000088,8,0,1,1
n1186,local,,local,local,4,2,1,2,3,0,20,0.000115,2,1,0,1
n1188,embraces,,embraces,embraces,2,15,0,1,1,0,536,0.000088,1,0,1,1
n1189,transdisciplinary,,transdisciplinary,transdisciplinary,10,15,3,5,8,0,20,0.00066,1,4,1,5
n1190,recreate,,recreate,recreate,2,13,0,1,1,0,537,0.000088,3,0,1,1
n1191,commonplace,,commonplace,commonplace,2,12,1,1,2,0,20,0.000143,4,1,1,2
n1192,reference,,reference,reference,2,12,1,1,2,0,20,0.000209,4,1,0,1
n1193,trips,,trips,trips,2,6,0,1,1,0,539,0.000088,3,0,1,1
n1194,internships,,internships,internships,2,6,1,1,2,0,538,0.000163,3,1,1,2
n1195,studentcentred,,studentcentred,studentcentred,4,17,2,2,4,0,20,0.000221,3,2,0,2
n1197,gordon2009,,gordon2009,gordon2009,4,1,0,1,1,0,541,0.000088,0,0,0,0
n1198,savery2006,,savery2006,savery2006,7,1,3,1,4,0,540,0.000312,0,0,0,0
n1199,forward,,forward,forward,8,1,1,1,2,0,20,0.00032,0,0,0,0
n1200,ontarioministryofeducation2013,,ontarioministryofeducation2013,ontarioministryofeducation2013,4,3,0,1,1,0,542,0.000088,10,0,2,2
n1201,possessing,,possessing,possessing,2,16,0,1,1,0,544,0.000088,4,0,1,1
n1202,capable,,capable,capable,6,16,2,1,3,0,543,0.000237,4,2,2,4
n1203,fielding2012,,fielding2012,fielding2012,4,1,0,1,1,0,545,0.000088,0,0,0,0
n1204,classroombased,,classroombased,classroombased,2,17,1,1,2,0,20,0.0002,3,0,1,1
n1205,knowledgepossessing,,knowledgepossessing,knowledgepossessing,2,16,0,1,1,0,546,0.000088,4,0,1,1
n1206,breunig2013,,breunig2013,breunig2013,2,1,0,1,1,0,547,0.000088,0,0,0,0
n1207,greifetal2006,,greifetal2006,greifetal2006,2,9,0,1,1,0,548,0.000088,1,0,0,0
n1208,hold,,hold,hold,2,9,1,1,2,0,20,0.000228,2,0,0,0
n1209,novel,,novel,novel,2,9,0,1,1,0,549,0.000088,4,0,0,0
n1210,inanimate,,inanimate,inanimate,2,9,1,1,2,0,282,0.000128,4,0,0,0
n1211,artifact,,artifact,artifact,10,9,3,5,8,0,20,0.000622,4,0,0,0
n1212,mobile,,mobile,mobile,8,9,2,1,3,0,20,0.000413,4,0,0,0
n1213,arguably,,arguably,arguably,2,2,0,1,1,0,550,0.000088,1,0,1,1
n1214,awareness,,awareness,awareness,4,1,2,2,4,0,20,0.000175,0,0,0,0
n1215,living–nonliving,,living–nonliving,living–nonliving,2,9,1,1,2,0,20,0.000162,6,0,0,0
n1216,member,,member,member,4,1,0,2,2,0,552,0.000088,0,0,0,0
n1217,food,,food,food,2,1,1,1,2,0,551,0.000125,0,0,0,0
n1218,backscheideretal1993,,backscheideretal1993,backscheideretal1993,2,9,0,1,1,0,556,0.000088,5,0,0,0
n1219,inagakihatano2002,,inagakihatano2002,inagakihatano2002,2,9,1,1,2,0,555,0.000163,5,0,0,0
n1220,keil1992,,keil1992,keil1992,2,9,1,1,2,0,554,0.000226,5,0,0,0
n1221,opfergelman2001,,opfergelman2001,opfergelman2001,2,9,1,1,2,0,553,0.00028,5,0,0,0
n1222,opfersiegler2004,,opfersiegler2004,opfersiegler2004,6,9,3,3,6,0,20,0.000657,5,0,0,0
n1223,correct,,correct,correct,6,9,2,3,5,0,20,0.000329,6,0,0,0
n1224,living,,living,living,4,9,2,2,4,0,20,0.000205,6,0,0,0
n1225,nonliving,,nonliving,nonliving,4,9,1,2,3,0,20,0.000175,6,0,0,0
n1226,immobile,,immobile,immobile,4,9,1,2,3,0,20,0.000175,6,0,0,0
n1227,alive,,alive,alive,6,5,1,3,4,0,20,0.000126,6,1,1,2
n1228,contrast,,contrast,contrast,2,9,0,1,1,0,557,0.000088,2,0,0,0
n1229,encounter,,encounter,encounter,2,9,1,1,2,0,20,0.000228,6,0,0,0
n1230,word,,word,word,8,5,2,4,6,0,20,0.000182,6,0,3,3
n1231,carey1985,,carey1985,carey1985,2,9,1,1,2,0,20,0.000194,5,0,0,0
n1232,hatanoetal1993,,hatanoetal1993,hatanoetal1993,2,9,1,1,2,0,20,0.000252,5,0,0,0
n1233,meuniercordier2004,,meuniercordier2004,meuniercordier2004,2,9,1,1,2,0,20,0.000302,5,0,0,0
n1234,richardssiegler1984,,richardssiegler1984,richardssiegler1984,2,9,1,1,2,0,13,0.000274,5,0,0,0
n1235,waxman2005,,waxman2005,waxman2005,1,9,1,0,1,0,12,0.000321,5,0,0,0
n1236,conceptualise,,conceptualise,conceptualise,1,1,0,1,1,0,558,0.000088,0,0,0,0
n1237,mediation,,mediation,mediation,4,5,0,2,2,0,559,0.000088,3,0,1,1
n1238,england,,england,england,2,12,0,1,1,0,560,0.000088,0,0,1,1
n1239,farmery2002,,farmery2002,farmery2002,2,3,0,1,1,0,562,0.000088,11,0,1,1
n1240,howedavies2005,,howedavies2005,howedavies2005,2,3,1,1,2,0,561,0.000163,11,1,1,2
n1241,risks,,risks,risks,2,3,0,1,1,0,563,0.000088,2,0,1,1
n1242,happen,,happen,happen,7,7,1,3,4,0,20,0.001136,0,3,2,5
n1243,schulz2012,,schulz2012,schulz2012,2,3,0,1,1,0,564,0.000088,2,0,1,1
n1244,exert,,exert,exert,2,7,1,1,2,0,20,0.000109,8,1,0,1
n1245,bjorklundgardiner2011p154,,bjorklundgardiner2011p154,bjorklundgardiner2011p154,2,19,1,1,2,0,20,0.000129,3,1,0,1
n1246,johnston2005,,johnston2005,johnston2005,4,3,0,2,2,0,565,0.000088,0,0,1,1
n1247,buoyancy,,buoyancy,buoyancy,2,16,0,1,1,0,566,0.000088,0,0,1,1
n1248,item,,item,item,2,13,0,1,1,0,567,0.000088,6,0,1,1
n1249,explorers,,explorers,explorers,2,16,0,1,1,0,568,0.000088,4,0,1,1
n1250,expect,,expect,expect,2,3,0,1,1,0,569,0.000088,2,0,1,1
n1251,keen,,keen,keen,2,5,0,1,1,0,570,0.000088,3,0,1,1
n1252,deboo2006,,deboo2006,deboo2006,2,3,0,1,1,0,572,0.000088,12,0,1,1
n1253,harlen2000,,harlen2000,harlen2000,2,3,1,1,2,0,571,0.000163,12,1,1,2
n1254,observers,,observers,observers,2,1,0,1,1,0,573,0.000088,0,0,0,0
n1255,much,,much,much,4,10,0,2,2,0,577,0.000088,6,0,2,2
n1256,watch,,watch,watch,2,10,1,1,2,0,576,0.000125,6,1,1,2
n1257,copying,,copying,copying,2,10,1,1,2,0,575,0.000194,6,1,0,1
n1258,everyday,,everyday,everyday,8,5,2,1,3,0,20,0.000154,3,1,2,3
n1259,rogoff2003,,rogoff2003,rogoff2003,2,4,0,1,1,0,578,0.000088,5,0,1,1
n1260,go,,go,go,6,15,2,3,5,0,20,0.000171,1,0,1,1
n1261,seeingit,,seeingit,seeingit,2,11,1,1,2,0,20,0.000118,8,0,1,1
n1262,noticing,,noticing,noticing,2,16,0,1,1,0,579,0.000088,6,0,1,1
n1263,sounds,,sounds,sounds,2,15,0,1,1,0,580,0.000088,5,0,1,1
n1264,container,,container,container,2,3,0,1,1,0,581,0.000088,2,0,1,1
n1265,touch,,touch,touch,2,6,0,1,1,0,582,0.000088,6,0,1,1
n1266,sound,,sound,sound,4,5,1,2,3,0,583,0.000226,3,1,1,2
n1267,quietest,,quietest,quietest,2,5,0,1,1,0,585,0.000088,3,0,1,1
n1268,loudest,,loudest,loudest,2,5,1,1,2,0,584,0.000163,3,1,1,2
n1269,sensemakingis,,sensemakingis,sensemakingis,2,17,0,1,1,0,587,0.000088,4,0,1,1
n1270,highlighted,,highlighted,highlighted,2,17,1,1,2,0,586,0.000163,4,1,1,2
n1271,eyfs,,eyfs,eyfs,2,1,0,1,1,0,588,0.000088,0,0,0,0
n1272,viewis,,viewis,viewis,2,1,0,1,1,0,589,0.000088,0,0,0,0
n1273,enquiring,,enquiring,enquiring,2,1,0,1,1,0,591,0.000088,0,0,0,0
n1274,minds,,minds,minds,2,1,1,1,2,0,590,0.000163,0,0,0,0
n1275,whilst,,whilst,whilst,4,14,0,2,2,0,592,0.000088,3,0,0,0
n1276,kallery2004,,kallery2004,kallery2004,2,3,0,1,1,0,594,0.000088,13,0,1,1
n1277,caveat,,caveat,caveat,2,3,1,1,2,0,593,0.000163,13,1,1,2
n1278,bruner,,bruner,bruner,2,2,1,1,2,0,20,0.00017,0,1,1,2
n1279,conceptualised,,conceptualised,conceptualised,2,2,1,1,2,0,20,0.000232,0,1,0,1
n1280,memorise,,memorise,memorise,2,2,1,1,2,0,202,0.000116,3,1,0,1
n1281,bruner1966p72,,bruner1966p72,bruner1966p72,2,2,0,1,1,0,595,0.000088,4,0,1,1
n1282,questionableharlen2000and,,questionableharlen2000and,questionableharlen2000and,2,4,0,1,1,0,596,0.000088,1,0,1,1
n1283,blakehowitt2012,,blakehowitt2012,blakehowitt2012,2,5,0,1,1,0,601,0.000088,8,0,1,1
n1284,harlen1999,,harlen1999,harlen1999,2,5,1,1,2,0,600,0.000163,8,1,1,2
n1285,johnston2009,,johnston2009,johnston2009,2,5,1,1,2,0,599,0.000226,8,1,1,2
n1286,howe,,howe,howe,4,5,1,1,2,0,598,0.00028,8,1,2,3
n1287,davies2005,,davies2005,davies2005,4,5,1,2,3,0,597,0.000326,8,2,1,3
n1288,black,,black,black,2,3,0,1,1,0,606,0.000088,14,0,1,1
n1289,hughes2003,,hughes2003,hughes2003,2,3,1,1,2,0,605,0.000163,14,1,1,2
n1290,lemke2001,,lemke2001,lemke2001,2,3,1,1,2,0,604,0.000226,14,1,1,2
n1291,concur,,concur,concur,2,3,1,1,2,0,603,0.00028,14,1,1,2
n1292,stress,,stress,stress,2,3,1,1,2,0,602,0.000326,14,1,1,2
n1293,contextualised,,contextualised,contextualised,2,13,0,1,1,0,608,0.000088,3,0,1,1
n1294,bound,,bound,bound,2,13,1,1,2,0,607,0.000163,3,1,1,2
n1295,socially,,socially,socially,2,13,0,1,1,0,609,0.000088,1,0,1,1
n1296,people,,people,people,2,8,0,1,1,0,610,0.000088,0,0,1,1
n1297,required,,required,required,2,3,0,1,1,0,611,0.000088,2,0,1,1
n1298,mediate,,mediate,mediate,4,3,2,1,3,0,20,0.000222,2,1,2,3
n1299,resonates,,resonates,resonates,2,1,0,1,1,0,613,0.000088,0,0,0,0
n1300,vygotskian,,vygotskian,vygotskian,2,1,1,1,2,0,612,0.000163,0,0,0,0
n1301,sociocultural,,sociocultural,sociocultural,6,1,2,3,5,0,20,0.000242,0,0,0,0
n1302,moreable,,moreable,moreable,2,9,1,1,2,0,20,0.000228,2,0,0,0
n1303,vygotsky19781986,,vygotsky19781986,vygotsky19781986,2,11,1,1,2,0,20,0.000154,6,1,0,1
n1304,claim,,claim,claim,18,5,4,8,12,0,20,0.000408,1,4,1,5
n1305,carefully,,carefully,carefully,8,7,2,1,3,0,20,0.000364,0,4,3,7
n1306,practitioner,,practitioner,practitioner,2,16,0,1,1,0,614,0.000088,2,0,1,1
n1307,evenapparently,,evenapparently,evenapparently,2,16,1,1,2,0,20,0.000135,2,1,0,1
n1308,intentional,,intentional,intentional,2,7,0,1,1,0,615,0.000088,4,0,1,1
n1309,howeverthey,,howeverthey,howeverthey,2,4,0,1,1,0,616,0.000088,1,0,1,1
n1310,vary,,vary,vary,2,5,0,1,1,0,617,0.000088,3,0,1,1
n1311,andor,,andor,andor,6,14,1,3,4,0,619,0.000125,7,0,0,0
n1312,childinitiated,,childinitiated,childinitiated,2,8,1,1,2,0,491,0.000107,2,1,0,1
n1313,intervening,,intervening,intervening,2,1,0,1,1,0,620,0.000088,0,0,0,0
n1314,initiate,,initiate,initiate,8,1,1,4,5,0,349,0.000143,0,0,0,0
n1315,deliberate,,deliberate,deliberate,2,2,0,1,1,0,621,0.000088,1,0,1,1
n1316,p159,,p159,p159,2,16,0,1,1,0,623,0.000088,9,0,1,1
n1317,balance,,balance,balance,2,16,1,1,2,0,622,0.000163,9,1,1,2
n1318,intervene,,intervene,intervene,4,16,1,2,3,0,20,0.000117,9,1,1,2
n1319,nuanced,,nuanced,nuanced,4,4,1,2,3,0,109,0.000113,2,1,1,2
n1320,behalf,,behalf,behalf,2,4,0,1,1,0,624,0.000088,1,0,1,1
n1321,pedagogic,,pedagogic,pedagogic,2,16,1,1,2,0,20,0.000138,9,1,1,2
n1322,covers,,covers,covers,2,1,0,1,1,0,625,0.000088,0,0,0,0
n1323,train,,train,train,2,16,0,1,1,0,626,0.000088,8,0,1,1
n1324,address,,address,address,8,16,3,4,7,0,20,0.000229,8,3,1,4
n1325,strength,,strength,strength,2,7,1,1,2,0,20,0.000144,9,1,0,1
n1326,premise,,premise,premise,4,1,1,2,3,0,20,0.000112,0,0,0,0
n1327,staff,,staff,staff,2,14,1,1,2,0,158,0.00012,6,0,0,0
n1328,assist,,assist,assist,2,2,0,1,1,0,627,0.000088,1,0,1,1
n1329,primarily,,primarily,primarily,2,1,0,1,1,0,628,0.000088,0,0,0,0
n1330,datausing,,datausing,datausing,2,1,0,1,1,0,629,0.000088,0,0,0,0
n1331,computational,,computational,computational,2,16,0,1,1,0,630,0.000088,4,0,1,1
n1332,less,,less,less,6,4,2,3,5,0,20,0.000144,5,2,1,3
n1335,interface,,interface,interface,2,8,1,1,2,0,20,0.000197,4,1,0,1
n1336,immersion,,immersion,immersion,2,1,0,1,1,0,633,0.000088,0,0,0,0
n1337,strategically,,strategically,strategically,2,5,0,1,1,0,634,0.000088,5,0,1,1
n1338,c,,c,c,4,19,1,2,3,0,20,0.000216,4,1,1,2
n1339,entwining,,entwining,entwining,2,19,1,1,2,0,20,0.00018,4,1,0,1
n1340,toplevel,,toplevel,toplevel,2,18,0,1,1,0,41,0.000088,4,0,0,0
n1341,subgoals,,subgoals,subgoals,3,19,1,1,2,0,20,0.00015,4,1,1,2
n1342,delight,,delight,delight,2,6,0,1,1,0,636,0.000088,4,0,1,1
n1343,illstructured,,illstructured,illstructured,2,7,0,1,1,0,637,0.000088,5,0,1,1
n1344,albeit,,albeit,albeit,2,16,0,1,1,0,638,0.000088,5,0,1,1
n1345,top,,top,top,2,10,0,1,1,0,639,0.000088,3,0,1,1
n1346,assess,,assess,assess,2,6,1,1,2,0,55,0.000111,5,1,0,1
n1347,mayr1997,,mayr1997,mayr1997,2,16,0,1,1,0,640,0.000088,6,0,1,1
n1348,unexplained,,unexplained,unexplained,2,3,0,1,1,0,643,0.000088,14,0,1,1
n1349,irregularity,,irregularity,irregularity,2,3,1,1,2,0,642,0.000163,14,1,1,2
n1350,anomaly,,anomaly,anomaly,2,3,1,1,2,0,641,0.000226,14,1,1,2
n1351,puzzle,,puzzle,puzzle,4,13,0,2,2,0,644,0.000088,4,0,1,1
n1352,conjecture,,conjecture,conjecture,6,6,2,3,5,0,20,0.000196,0,1,1,2
n1353,thereof,,thereof,thereof,1,13,1,0,1,0,15,0.000141,4,1,0,1
n1354,driveretal,,driveretal,driveretal,1,7,1,0,1,0,18,0.00041,0,1,0,1
n1355,strong,,strong,strong,14,10,4,1,5,0,20,0.001098,7,3,2,5
n1356,naïve,,naïve,naïve,6,10,2,1,3,0,20,0.001163,7,3,3,6
n1357,realism,,realism,realism,6,10,1,1,2,0,20,0.001076,7,3,0,3
n1358,secondary,,secondary,secondary,6,7,2,3,5,0,20,0.000514,3,2,1,3
n1359,manifest,,manifest,manifest,4,8,0,2,2,0,646,0.000088,5,0,1,1
n1360,subsequent,,subsequent,subsequent,6,8,1,3,4,0,645,0.000125,5,1,2,3
n1361,away,,away,away,2,1,0,1,1,0,648,0.000088,0,0,0,0
n1362,phenomenology,,phenomenology,phenomenology,2,1,1,1,2,0,647,0.000163,0,0,0,0
n1363,variable,,variable,variable,2,4,0,1,1,0,649,0.000088,5,0,1,1
n1364,driveretals,,driveretals,driveretals,2,8,1,1,2,0,20,0.000121,6,0,1,1
n1365,finer,,finer,finer,2,8,1,1,2,0,20,0.000191,6,1,1,2
n1366,grain,,grain,grain,4,8,2,2,4,0,20,0.000388,6,2,2,4
n1367,vestiges,,vestiges,vestiges,2,10,1,1,2,0,20,0.000167,7,0,1,1
n1368,observable,,observable,observable,2,8,1,1,2,0,20,0.000121,2,1,1,2
n1369,takenforgranted,,takenforgranted,takenforgranted,2,13,0,1,1,0,650,0.000088,3,0,1,1
n1370,p115,,p115,p115,4,12,1,2,3,0,442,0.000194,7,1,1,2
n1371,onetoone,,onetoone,onetoone,2,14,0,1,1,0,651,0.000088,3,0,0,0
n1372,factor,,factor,factor,2,12,1,1,2,0,443,0.000125,7,1,1,2
n1373,minority,,minority,minority,2,14,0,1,1,0,654,0.000088,0,0,0,0
n1374,16yearolds,,16yearolds,16yearolds,2,14,1,1,2,0,653,0.000163,0,0,0,0
n1375,exhibited,,exhibited,exhibited,2,14,1,1,2,0,652,0.000226,0,0,0,0
n1376,provisional,,provisional,provisional,2,3,0,1,1,0,656,0.000088,14,0,1,1
n1377,status,,status,status,2,3,1,1,2,0,655,0.000163,14,1,1,2
n1378,directly,,directly,directly,2,5,1,1,2,0,14,0.000144,4,0,1,1
n1379,coherent,,coherent,coherent,2,11,0,1,1,0,657,0.000088,3,0,1,1
n1380,posited,,posited,posited,2,14,0,1,1,0,658,0.000088,2,0,0,0
n1381,imagination,,imagination,imagination,2,6,0,1,1,0,659,0.000088,0,0,1,1
n1382,lehrerschauble2000,,lehrerschauble2000,lehrerschauble2000,2,16,0,1,1,0,660,0.000088,8,0,1,1
n1383,syntactic,,syntactic,syntactic,2,14,0,1,1,0,662,0.000088,4,0,0,0
n1384,analogical,,analogical,analogical,2,14,1,1,2,0,661,0.000163,4,0,0,0
n1385,hypotheticaldeductive,,hypotheticaldeductive,hypotheticaldeductive,2,14,0,1,1,0,663,0.000088,4,0,0,0
n1386,adequacy,,adequacy,adequacy,2,4,0,1,1,0,664,0.000088,3,0,1,1
n1387,instrument,,instrument,instrument,4,16,0,2,2,0,665,0.000088,8,0,2,2
n1388,policy,,policy,policy,3,17,1,2,3,0,533,0.000125,5,1,1,2
n1389,situate,,situate,situate,4,1,2,2,4,0,20,0.000212,0,0,0,0
n1390,trend,,trend,trend,4,11,0,2,2,0,666,0.000088,7,0,1,1
n1391,recent,,recent,recent,3,5,0,2,2,0,667,0.000088,1,0,1,1
n1392,osborne2014,,osborne2014,osborne2014,2,14,0,1,1,0,669,0.000088,2,0,0,0
n1393,osborne,,osborne,osborne,2,14,1,1,2,0,668,0.000163,2,0,0,0
n1394,commitment,,commitment,commitment,2,2,1,1,2,0,225,0.000125,1,1,0,1
n1395,reforms,,reforms,reforms,2,17,1,1,2,0,532,0.000141,5,1,1,2
n1396,aligned,,aligned,aligned,2,3,0,1,1,0,670,0.000088,3,0,1,1
n1397,adopting,,adopting,adopting,2,3,0,1,1,0,671,0.000088,2,0,1,1
n1398,core,,core,core,4,2,1,2,3,0,20,0.000103,1,0,1,1
n1399,exemplified,,exemplified,exemplified,2,13,0,1,1,0,672,0.000088,3,0,1,1
n1400,ngss,,ngss,ngss,2,8,1,1,2,0,242,0.000099,7,0,1,1
n1401,nrc2012,,nrc2012,nrc2012,4,8,1,2,3,0,20,0.000183,7,1,2,3
n1402,examination,,examination,examination,2,8,1,1,2,0,20,0.000166,7,1,0,1
n1403,7,,7,7,2,3,0,1,1,0,673,0.000088,15,0,1,1
n1404,evidenceexplanation,,evidenceexplanation,evidenceexplanation,2,11,1,1,2,0,179,0.000165,7,1,1,2
n1405,ee,,ee,ee,2,11,1,1,2,0,178,0.000228,7,1,1,2
n1406,continuum,,continuum,continuum,2,11,1,1,2,0,177,0.000282,8,1,1,2
n1407,ascertain,,ascertain,ascertain,2,14,0,1,1,0,674,0.000088,7,0,0,0
n1408,duschl,,duschl,duschl,4,15,1,2,3,0,209,0.000126,2,0,1,1
n1409,outeach,,outeach,outeach,2,11,1,1,2,0,20,0.00017,8,0,1,1
n1410,se,,se,se,2,11,1,1,2,0,20,0.000232,8,1,1,2
n1411,transitions,,transitions,transitions,2,11,1,1,2,0,20,0.000285,8,1,1,2
n1412,count,,count,count,4,5,2,2,4,0,20,0.000145,5,1,1,2
n1413,second,,second,second,10,15,4,5,9,0,20,0.000525,4,1,3,4
n1414,potential,,potential,potential,4,15,0,2,2,0,675,0.000088,4,0,1,1
n1415,disconfirm,,disconfirm,disconfirm,2,5,0,1,1,0,676,0.000088,1,0,1,1
n1416,day,,day,day,6,3,1,3,4,0,20,0.000103,4,1,2,3
n1417,fiction,,fiction,fiction,2,9,0,1,1,0,678,0.000088,7,0,0,0
n1418,nonfiction,,nonfiction,nonfiction,2,9,1,1,2,0,677,0.000163,7,0,0,0
n1419,wrap,,wrap,wrap,4,13,0,2,2,0,679,0.000088,8,0,1,1
n1420,chart,,chart,chart,2,16,0,1,1,0,680,0.000088,1,0,1,1
n1421,sociocognitive,,sociocognitive,sociocognitive,2,16,0,1,1,0,681,0.000088,3,0,1,1
n1422,resembling,,resembling,resembling,4,14,0,2,2,0,682,0.000088,7,0,0,0
n1423,reconstruct,,reconstruct,reconstruct,4,9,1,2,3,0,171,0.000131,2,0,0,0
n1424,gottduggan1995,,gottduggan1995,gottduggan1995,2,6,0,1,1,0,684,0.000088,0,0,1,1
n1425,etkinavanheuvelen2007,,etkinavanheuvelen2007,etkinavanheuvelen2007,2,6,1,1,2,0,683,0.000163,0,1,1,2
n1426,blumniss1991,,blumniss1991,blumniss1991,2,14,0,1,1,0,687,0.000088,8,0,0,0
n1427,erickson1999,,erickson1999,erickson1999,2,14,1,1,2,0,686,0.000163,8,0,0,0
n1428,lubienski1999,,lubienski1999,lubienski1999,2,14,1,1,2,0,685,0.000226,8,0,0,0
n1429,constantinou1999,,constantinou1999,constantinou1999,2,3,0,1,1,0,691,0.000088,15,0,1,1
n1430,english2003,,english2003,english2003,2,3,1,1,2,0,690,0.000163,15,1,1,2
n1431,leshlehrer2003,,leshlehrer2003,leshlehrer2003,2,3,1,1,2,0,689,0.000226,15,1,1,2
n1432,loucazacharia2012,,loucazacharia2012,loucazacharia2012,2,3,1,1,2,0,688,0.00028,15,1,1,2
n1433,generic,,generic,generic,2,15,0,1,1,0,692,0.000088,7,0,1,1
n1434,cpd,,cpd,cpd,2,1,1,1,2,0,20,0.000144,0,0,0,0
n1435,impose,,impose,impose,2,14,0,1,1,0,693,0.000088,2,0,0,0
n1438,zechetal2000,,zechetal2000,zechetal2000,1,12,0,1,1,0,696,0.000088,8,0,1,1
n1439,originated,,originated,originated,2,18,0,1,1,0,42,0.000088,4,0,0,0
n1440,enough,,enough,enough,6,7,2,3,5,0,20,0.000155,8,1,1,2
n1441,slp,,slp,slp,5,12,2,3,5,0,698,0.000355,8,2,1,3
n1442,panel,,panel,panel,2,1,0,1,1,0,700,0.000088,0,0,0,0
n1443,experts,,experts,experts,2,1,1,1,2,0,699,0.000163,0,0,0,0
n1444,grandy2008these,,grandy2008these,grandy2008these,2,15,1,1,2,0,208,0.000142,2,1,1,2
n1445,validation,,validation,validation,2,14,0,1,1,0,701,0.000088,3,0,0,0
n1446,norm,,norm,norm,12,1,3,1,4,0,20,0.00026,0,0,0,0
n1447,scholars,,scholars,scholars,2,1,0,1,1,0,702,0.000088,0,0,0,0
n1448,regulation,,regulation,regulation,2,1,0,1,1,0,703,0.000088,0,0,0,0
n1449,posit,,posit,posit,2,1,0,1,1,0,704,0.000088,0,0,0,0
n1450,unique,,unique,unique,2,13,0,1,1,0,705,0.000088,3,0,1,1
n1451,chinnsamarapungavan2008,,chinnsamarapungavan2008,chinnsamarapungavan2008,2,12,0,1,1,0,708,0.000088,8,0,1,1
n1452,suppes19601962,,suppes19601962,suppes19601962,2,12,1,1,2,0,707,0.000163,8,1,1,2
n1453,woodward1989,,woodward1989,woodward1989,2,12,1,1,2,0,706,0.000226,8,1,1,2
n1454,vocabulary,,vocabulary,vocabulary,6,8,1,3,4,0,20,0.000149,2,0,1,1
n1455,laws,,laws,laws,2,13,1,1,2,0,20,0.000547,4,0,1,1
n1456,ongoing,,ongoing,ongoing,4,15,1,2,3,0,20,0.000124,7,1,1,2
n1457,utility,,utility,utility,2,8,0,1,1,0,709,0.000088,2,0,1,1
n1458,history,,history,history,2,8,1,1,2,0,20,0.000121,2,1,0,1
n1459,philosophy,,philosophy,philosophy,4,1,1,2,3,0,20,0.000191,0,0,0,0
n1460,cartwright19831999,,cartwright19831999,cartwright19831999,2,14,0,1,1,0,712,0.000088,3,0,0,0
n1461,giere1988kuhn1962,,giere1988kuhn1962,giere1988kuhn1962,2,14,1,1,2,0,711,0.000163,3,0,0,0
n1462,laudan1990,,laudan1990,laudan1990,2,14,1,1,2,0,710,0.000226,3,0,0,0
n1463,publications,,publications,publications,2,12,0,1,1,0,713,0.000088,8,0,1,1
n1464,spaces,,spaces,spaces,2,13,0,1,1,0,714,0.000088,8,0,1,1
n1465,conventions,,conventions,conventions,2,13,1,1,2,0,20,0.000125,8,1,1,2
n1466,criterion,,criterion,criterion,4,11,1,2,3,0,715,0.000163,1,1,1,2
n1468,preinquiry,,preinquiry,preinquiry,2,7,0,1,1,0,716,0.000088,4,0,1,1
n1469,post,,post,post,1,1,0,1,1,0,717,0.000088,0,0,0,0
n1470,presentations,,presentations,presentations,2,10,0,1,1,0,718,0.000088,0,0,1,1
n1471,limitations,,limitations,limitations,2,3,0,1,1,0,720,0.000088,16,0,1,1
n1472,empowering,,empowering,empowering,2,3,1,1,2,0,719,0.000163,16,1,1,2
n1473,zhangetal2011,,zhangetal2011,zhangetal2011,2,9,1,1,2,0,20,0.000129,7,0,0,0
n1474,indicators,,indicators,indicators,2,16,1,1,2,0,20,0.000156,8,1,1,2
n1475,reveal,,reveal,reveal,6,16,2,3,5,0,20,0.000258,8,2,1,3
n1476,parents,,parents,parents,4,19,0,2,2,0,721,0.000088,1,0,1,1
n1477,participated,,participated,participated,2,1,0,1,1,0,722,0.000088,0,0,0,0
n1478,eshach2011p442,,eshach2011p442,eshach2011p442,2,2,1,1,2,0,151,0.000103,2,0,1,1
n1479,administered,,administered,administered,2,9,1,1,2,0,20,0.000129,7,0,0,0
n1480,invention,,invention,invention,2,3,0,1,1,0,723,0.000088,1,0,1,1
n1481,intervention,,intervention,intervention,2,3,1,1,2,0,20,0.000125,1,1,1,2
n1482,scores,,scores,scores,2,3,0,1,1,0,724,0.000088,1,0,1,1
n1483,respect,,respect,respect,6,11,1,3,4,0,20,0.000121,0,1,1,2
n1484,wondering,,wondering,wondering,2,5,0,1,1,0,725,0.000088,0,0,1,1
n1485,provoked,,provoked,provoked,2,14,0,1,1,0,726,0.000088,1,0,0,0
n1486,human,,human,human,6,1,2,3,5,0,20,0.0002,0,0,0,0
n1487,beings,,beings,beings,2,6,1,1,2,0,20,0.000145,0,0,1,1
n1488,desire,,desire,desire,2,1,0,1,1,0,727,0.000088,0,0,0,0
n1489,harlanrivkin2008p4,,harlanrivkin2008p4,harlanrivkin2008p4,2,17,1,1,2,0,20,0.000129,1,1,1,2
n1490,barell2008,,barell2008,barell2008,2,17,1,1,2,0,20,0.000197,1,1,1,2
n1491,born,,born,born,2,14,0,1,1,0,728,0.000088,1,0,0,0
n1492,foster,,foster,foster,2,3,0,1,1,0,730,0.000088,2,0,1,1
n1493,keep,,keep,keep,6,3,1,1,2,0,729,0.000163,2,1,2,3
n1494,wonder,,wonder,wonder,2,2,0,1,1,0,732,0.000088,1,0,1,1
n1495,journal,,journal,journal,2,2,1,1,2,0,731,0.000163,1,1,1,2
n1496,problematic,,problematic,problematic,4,18,0,2,2,0,43,0.000088,5,0,0,0
n1497,scenarios,,scenarios,scenarios,6,18,2,3,5,0,2,0.000403,5,0,0,0
n1498,garnering,,garnering,garnering,2,18,1,1,2,0,1,0.000202,5,0,0,0
n1499,parental,,parental,parental,2,18,1,1,2,0,0,0.00026,5,0,0,0
n1500,rankin2011,,rankin2011,rankin2011,2,8,1,1,2,0,20,0.000171,3,1,0,1
n1501,sustained,,sustained,sustained,2,14,0,1,1,0,734,0.000088,6,0,0,0
n1502,bentleyetal2007,,bentleyetal2007,bentleyetal2007,2,15,0,1,1,0,736,0.000088,4,0,1,1
n1503,martinetal2009,,martinetal2009,martinetal2009,4,15,1,2,3,0,735,0.000163,4,1,1,2
n1504,aware,,aware,aware,4,4,1,2,3,0,20,0.000111,5,1,0,1
n1505,nowadays,,nowadays,nowadays,2,3,0,1,1,0,737,0.000088,5,0,1,1
n1506,endeavor,,endeavor,endeavor,2,2,1,1,2,0,146,0.000123,1,0,1,1
n1507,nation,,nation,nation,4,10,2,1,3,0,574,0.0002,6,2,2,4
n1508,obvious,,obvious,obvious,2,3,0,1,1,0,738,0.000088,0,0,1,1
n1509,endeavors,,endeavors,endeavors,2,3,1,1,2,0,64,0.000116,0,1,1,2
n1510,1981,,1981,1981,2,3,1,1,2,0,63,0.000187,0,1,1,2
n1511,commission,,commission,commission,4,3,2,2,4,0,20,0.000271,0,1,2,3
n1512,quality,,quality,quality,6,4,1,3,4,0,20,0.000138,7,1,2,3
n1513,almost,,almost,almost,2,1,0,1,1,0,739,0.000088,0,0,0,0
n1514,released,,released,released,2,3,1,1,2,0,20,0.000203,0,1,0,1
n1515,named,,named,named,2,10,0,1,1,0,740,0.000088,6,0,1,1
n1516,imperative,,imperative,imperative,2,10,1,1,2,0,217,0.000161,6,1,0,1
n1517,reform,,reform,reform,2,9,0,1,1,0,741,0.000088,1,0,0,0
n1518,courses,,courses,courses,2,4,0,1,1,0,742,0.000088,3,0,1,1
n1519,citizens,,citizens,citizens,4,6,2,2,4,0,20,0.000161,6,1,2,3
n1520,anationatrisk1983,,anationatrisk1983,anationatrisk1983,2,18,1,1,2,0,32,0.000112,3,0,0,0
n1521,2000s,,2000s,2000s,2,10,0,1,1,0,743,0.000088,7,0,1,1
n1522,effort,,effort,effort,4,18,0,2,2,0,44,0.000088,4,0,0,0
n1523,turkey,,turkey,turkey,2,14,0,1,1,0,745,0.000088,7,0,0,0
n1524,parallel,,parallel,parallel,2,13,0,1,1,0,746,0.000088,3,0,1,1
n1525,bulut2007,,bulut2007,bulut2007,2,4,1,1,2,0,20,0.000102,8,1,0,1
n1526,bahar2006,,bahar2006,bahar2006,2,6,1,1,2,0,20,0.000156,6,1,1,2
n1527,clues,,clues,clues,2,16,1,1,2,0,20,0.000161,8,1,0,1
n1528,extent,,extent,extent,2,9,0,1,1,0,748,0.000088,1,0,0,0
n1529,turkish,,turkish,turkish,2,9,1,1,2,0,747,0.000163,1,0,0,0
n1530,dialectical,,dialectical,dialectical,4,12,2,2,4,0,20,0.000301,9,2,0,2
n1531,interactants,,interactants,interactants,2,20,1,1,2,0,121,0.000134,4,1,1,2
n1532,dialoaic,,dialoaic,dialoaic,2,6,1,1,2,0,20,0.000126,2,1,0,1
n1533,ash2004,,ash2004,ash2004,3,18,1,1,2,0,45,0.0001,0,0,0,0
n1534,gallas1995,,gallas1995,gallas1995,2,12,1,1,2,0,20,0.00011,9,0,1,1
n1535,lemke1990,,lemke1990,lemke1990,2,12,1,1,2,0,20,0.000181,9,1,1,2
n1536,depict,,depict,depict,4,1,1,2,3,0,125,0.000133,0,0,0,0
n1537,engestrommiettinen1999p9,,engestrommiettinen1999p9,engestrommiettinen1999p9,2,1,0,1,1,0,749,0.000088,0,0,0,0
n1538,pertain,,pertain,pertain,2,1,0,1,1,0,750,0.000088,0,0,0,0
n1539,pouring,,pouring,pouring,2,15,1,1,2,0,20,0.000136,1,1,1,2
n1540,volume,,volume,volume,2,1,0,1,1,0,751,0.000088,0,0,0,0
n1541,feeds,,feeds,feeds,2,3,0,1,1,0,752,0.000088,0,0,1,1
n1542,goal–orient,,goal–orient,goal–orient,2,1,0,1,1,0,753,0.000088,0,0,0,0
n1543,standardized,,standardized,standardized,4,8,2,2,4,0,20,0.000291,8,1,2,3
n1544,ore,,ore,ore,2,8,1,1,2,0,20,0.000211,8,1,1,2
n1545,stablished,,stablished,stablished,2,8,1,1,2,0,20,0.000268,8,1,0,1
n1546,contrary,,contrary,contrary,2,7,1,1,2,0,74,0.000226,2,1,0,1
n1547,precede,,precede,precede,2,8,1,1,2,0,20,0.000109,8,1,1,2
n1548,origin,,origin,origin,2,8,1,1,2,0,20,0.00018,8,1,1,2
n1549,canonical,,canonical,canonical,2,8,1,1,2,0,20,0.000211,8,1,0,1
n1550,schliebenlange1987,,schliebenlange1987,schliebenlange1987,2,19,1,1,2,0,20,0.000187,0,0,1,1
n1551,institutional,,institutional,institutional,2,7,0,1,1,0,754,0.000088,8,0,1,1
n1552,rooted,,rooted,rooted,2,12,1,1,2,0,20,0.000155,2,1,0,1
n1553,configuring,,configuring,configuring,2,14,0,1,1,0,755,0.000088,4,0,0,0
n1554,pekarekdoehlerziegler2007p85,,pekarekdoehlerziegler2007p85,pekarekdoehlerziegler2007p85,2,13,0,1,1,0,756,0.000088,0,0,1,1
n1555,consequently,,consequently,consequently,2,7,1,1,2,0,20,0.000187,3,0,1,1
n1556,informal,,informal,informal,2,2,1,1,2,0,201,0.000116,3,1,0,1
n1557,unfolding,,unfolding,unfolding,2,6,0,1,1,0,757,0.000088,1,0,1,1
n1558,energy,,energy,energy,3,13,0,1,1,0,760,0.000088,7,0,1,1
n1559,lijnse1990,,lijnse1990,lijnse1990,2,13,1,1,2,0,759,0.000163,7,1,1,2
n1560,trumper1990,,trumper1990,trumper1990,2,13,1,1,2,0,758,0.000226,7,1,1,2
n1561,vanhooketal2005,,vanhooketal2005,vanhooketal2005,2,12,0,1,1,0,762,0.000088,0,0,1,1
n1562,vanhookhuziakclark2007b,,vanhookhuziakclark2007b,vanhookhuziakclark2007b,2,12,1,1,2,0,761,0.000163,0,1,1,2
n1563,air,,air,air,2,4,0,1,1,0,764,0.000088,8,0,1,1
n1564,magnetism,,magnetism,magnetism,2,4,1,1,2,0,763,0.000163,8,1,1,2
n1565,succinct,,succinct,succinct,2,20,0,1,1,0,765,0.000088,2,0,1,1
n1566,phrase,,phrase,phrase,6,20,2,3,5,0,20,0.000277,2,2,1,3
n1567,hooks,,hooks,hooks,6,18,1,3,4,0,8,0.000327,5,0,0,0
n1568,capture,,capture,capture,4,1,2,1,3,0,20,0.000467,0,0,0,0
n1569,multisensory,,multisensory,multisensory,4,7,1,1,2,0,20,0.000135,4,0,2,2
n1570,ripe,,ripe,ripe,9,14,1,1,2,0,20,0.000114,4,0,0,0
n1571,aid,,aid,aid,2,12,0,1,1,0,766,0.000088,0,0,1,1
n1572,abstract,,abstract,abstract,2,2,1,1,2,0,20,0.000115,2,1,1,2
n1573,kinesthetic,,kinesthetic,kinesthetic,2,12,0,1,1,0,767,0.000088,4,0,1,1
n1574,song,,song,song,2,1,0,1,1,0,768,0.000088,0,0,0,0
n1575,remember,,remember,remember,2,15,0,1,1,0,769,0.000088,2,0,1,1
n1576,intensely,,intensely,intensely,2,2,0,1,1,0,770,0.000088,3,0,1,1
n1577,brief,,brief,brief,2,20,1,1,2,0,20,0.000135,2,1,1,2
n1578,lift,,lift,lift,2,18,1,1,2,0,7,0.00018,6,0,0,0
n1579,squeeze,,squeeze,squeeze,2,18,1,1,2,0,6,0.000241,6,0,0,0
n1580,stretch,,stretch,stretch,2,18,1,1,2,0,5,0.000293,6,0,0,0
n1581,twist,,twist,twist,2,18,1,1,2,0,4,0.000337,6,0,0,0
n1582,devolve,,devolve,devolve,2,2,0,1,1,0,772,0.000088,1,0,1,1
n1583,lecture,,lecture,lecture,2,2,1,1,2,0,771,0.000163,1,1,1,2
n1584,flourish,,flourish,flourish,2,3,0,1,1,0,773,0.000088,3,0,1,1
n1585,helmkatz2011,,helmkatz2011,helmkatz2011,5,16,1,2,3,0,20,0.000117,9,1,1,2
n1586,ideally,,ideally,ideally,2,16,1,1,2,0,20,0.000138,9,1,0,1
n1587,due,,due,due,2,4,1,1,2,0,20,0.000121,5,1,0,1
n1588,constraints,,constraints,constraints,2,7,1,1,2,0,20,0.00013,3,1,1,2
n1589,mini,,mini,mini,2,7,1,1,2,0,20,0.000199,3,1,0,1
n1590,rain,,rain,rain,13,5,6,6,12,0,20,0.000654,0,2,5,7
n1591,weather,,weather,weather,4,5,2,2,4,0,20,0.000209,6,2,0,2
n1592,extracted,,extracted,extracted,2,13,1,1,2,0,20,0.000171,5,1,1,2
n1593,afterwards,,afterwards,afterwards,2,3,1,1,2,0,20,0.000127,0,1,1,2
n1594,returned,,returned,returned,2,13,1,1,2,0,20,0.000119,5,1,1,2
n1595,indepth,,indepth,indepth,2,4,1,1,2,0,20,0.000103,3,0,1,1
n1596,twoweek,,twoweek,twoweek,2,5,0,1,1,0,775,0.000088,0,0,1,1
n1597,span,,span,span,2,5,1,1,2,0,774,0.000163,0,1,1,2
n1598,performed,,performed,performed,2,5,0,1,1,0,776,0.000088,0,0,1,1
n1599,referenced,,referenced,referenced,2,7,1,1,2,0,20,0.000122,3,0,1,1
n1600,showcase,,showcase,showcase,2,20,1,1,2,0,20,0.000123,1,1,0,1
n1601,culminating,,culminating,culminating,2,7,1,1,2,0,20,0.000144,4,0,1,1
n1602,experiencepeters2006,,experiencepeters2006,experiencepeters2006,2,5,0,1,1,0,777,0.000088,3,0,1,1
n1603,rop2002,,rop2002,rop2002,2,5,0,1,1,0,778,0.000088,1,0,1,1
n1604,–,,–,–,8,8,0,4,4,0,782,0.000088,3,0,2,2
n1605,receptive,,receptive,receptive,6,4,2,1,3,0,20,0.000274,0,1,3,4
n1606,outpouring,,outpouring,outpouring,2,5,1,1,2,0,309,0.000125,0,1,1,2
n1607,ambivalent,,ambivalent,ambivalent,2,6,1,1,2,0,20,0.000128,6,0,1,1
n1608,contradictory,,contradictory,contradictory,2,3,0,1,1,0,784,0.000088,14,0,1,1
n1609,feelings,,feelings,feelings,2,3,1,1,2,0,783,0.000163,14,1,1,2
n1610,honour,,honour,honour,2,3,1,1,2,0,20,0.000136,14,1,1,2
n1611,struggle,,struggle,struggle,2,1,0,1,1,0,785,0.000088,0,0,0,0
n1612,weighed,,weighed,weighed,2,8,1,1,2,0,781,0.000107,3,1,1,2
n1613,seemingly,,seemingly,seemingly,2,8,1,1,2,0,780,0.000178,3,1,1,2
n1614,incompatible,,incompatible,incompatible,2,8,1,1,2,0,779,0.00024,3,1,0,1
n1615,maximize,,maximize,maximize,2,4,1,1,2,0,20,0.000136,1,0,1,1
n1616,cover,,cover,cover,2,7,1,1,2,0,20,0.00013,3,1,1,2
n1617,compassionate,,compassionate,compassionate,2,4,1,1,2,0,20,0.000129,5,1,1,2
n1618,annoying,,annoying,annoying,2,8,0,1,1,0,787,0.000088,6,0,1,1
n1619,going,,going,going,2,8,1,1,2,0,786,0.000163,6,1,1,2
n1620,impediment,,impediment,impediment,2,8,1,1,2,0,20,0.000253,6,1,1,2
n1621,overbearing,,overbearing,overbearing,2,8,1,1,2,0,20,0.000303,6,1,0,1
n1622,patience,,patience,patience,4,2,2,2,4,0,20,0.000217,5,1,2,3
n1623,arrive,,arrive,arrive,2,11,1,1,2,0,20,0.000126,5,0,1,1
n1624,receiving,,receiving,receiving,2,16,0,1,1,0,790,0.000088,8,0,1,1
n1625,common,,common,common,2,16,1,1,2,0,789,0.000163,8,1,1,2
n1626,wisdom,,wisdom,wisdom,2,16,1,1,2,0,788,0.000226,8,1,1,2
n1627,rapid,,rapid,rapid,2,2,0,1,1,0,792,0.000088,5,0,1,1
n1628,succession,,succession,succession,2,2,1,1,2,0,791,0.000163,5,1,1,2
n1629,exhorting,,exhorting,exhorting,2,2,1,1,2,0,20,0.00018,5,1,1,2
n1630,power,,power,power,2,2,1,1,2,0,20,0.000129,2,1,1,2
n1631,attitudes,,attitudes,attitudes,2,11,0,1,1,0,793,0.000088,1,0,1,1
n1632,discouraged,,discouraged,discouraged,2,7,0,1,1,0,794,0.000088,3,0,1,1
n1633,nursery,,nursery,nursery,2,7,1,1,2,0,20,0.000131,3,1,1,2
n1634,micropolitics,,micropolitics,micropolitics,2,8,1,1,2,0,20,0.000197,1,1,1,2
n1635,pedrosadejesusetal2012,,pedrosadejesusetal2012,pedrosadejesusetal2012,2,1,0,1,1,0,795,0.000088,0,0,0,0
n1636,occasion,,occasion,occasion,4,2,1,2,3,0,797,0.000163,5,1,2,3
n1637,brezillon20032005,,brezillon20032005,brezillon20032005,2,2,1,1,2,0,796,0.000157,5,1,1,2
n1638,intellectual,,intellectual,intellectual,2,6,1,1,2,0,20,0.000223,8,1,0,1
n1639,caudron2000p55,,caudron2000p55,caudron2000p55,2,4,0,1,1,0,799,0.000088,0,0,1,1
n1640,positive,,positive,positive,2,4,1,1,2,0,798,0.000163,0,1,1,2
n1641,usual,,usual,usual,2,12,1,1,2,0,20,0.000143,4,1,0,1
n1642,prime,,prime,prime,2,11,0,1,1,0,800,0.000088,1,0,1,1
n1643,arepositive,,arepositive,arepositive,2,6,0,1,1,0,802,0.000088,3,0,1,1
n1644,numerous,,numerous,numerous,2,6,1,1,2,0,801,0.000163,3,1,1,2
n1645,dismissed,,dismissed,dismissed,2,11,0,1,1,0,804,0.000088,6,0,1,1
n1646,welcomed,,welcomed,welcomed,2,11,1,1,2,0,803,0.000163,6,1,1,2
n1647,answerable,,answerable,answerable,2,16,0,1,1,0,805,0.000088,8,0,1,1
n1648,wattspedrosadejesus2006,,wattspedrosadejesus2006,wattspedrosadejesus2006,2,16,1,1,2,0,20,0.000156,8,1,0,1
n1649,mode,,mode,mode,2,5,0,1,1,0,806,0.000088,0,0,1,1
n1650,resolution,,resolution,resolution,2,5,1,1,2,0,20,0.000122,7,1,1,2
n1651,investigable,,investigable,investigable,2,5,1,1,2,0,20,0.000192,7,1,1,2
n1652,chinkayalvizhi2002,,chinkayalvizhi2002,chinkayalvizhi2002,6,16,1,3,4,0,20,0.000148,2,0,2,2
n1653,graessermcmahen1993,,graessermcmahen1993,graessermcmahen1993,2,2,1,1,2,0,20,0.00013,5,0,1,1
n1654,ingredient,,ingredient,ingredient,4,8,1,2,3,0,20,0.00017,4,2,1,3
n1655,questionasking,,questionasking,questionasking,2,15,0,1,1,0,807,0.000088,4,0,1,1
n1656,transgressive,,transgressive,transgressive,2,15,1,1,2,0,20,0.000177,4,1,0,1
n1657,third,,third,third,2,16,0,1,1,0,808,0.000088,2,0,1,1
n1658,tack,,tack,tack,1,1,0,1,1,0,809,0.000088,0,0,0,0
n1659,vastly,,vastly,vastly,2,8,1,1,2,0,20,0.00016,4,1,0,1
n1660,entailed,,entailed,entailed,2,1,0,1,1,0,810,0.000088,0,0,0,0
n1661,arnold2009,,arnold2009,arnold2009,2,16,1,1,2,0,20,0.00013,2,1,1,2
n1662,full,,full,full,6,15,1,3,4,0,811,0.000163,2,1,1,2
n1663,remaining,,remaining,remaining,2,1,0,1,1,0,812,0.000088,0,0,0,0
n1664,spring,,spring,spring,2,5,0,1,1,0,814,0.000088,2,0,1,1
n1665,odd,,odd,odd,2,5,1,1,2,0,813,0.000163,2,1,1,2
n1666,passing,,passing,passing,2,5,1,1,2,0,377,0.000152,2,1,1,2
n1667,occurrence,,occurrence,occurrence,2,7,1,1,2,0,20,0.000137,10,1,1,2
n1668,television,,television,television,2,2,1,1,2,0,20,0.000131,6,0,1,1
n1669,advert,,advert,advert,2,2,1,1,2,0,20,0.000199,6,1,1,2
n1670,pets,,pets,pets,2,2,1,1,2,0,20,0.000257,6,1,1,2
n1671,habits,,habits,habits,2,2,1,1,2,0,20,0.000307,6,1,1,2
n1672,sporting,,sporting,sporting,2,2,0,1,1,0,815,0.000088,5,0,1,1
n1673,obsessions,,obsessions,obsessions,2,2,1,1,2,0,20,0.000177,6,1,1,2
n1674,hobbies,,hobbies,hobbies,2,2,1,1,2,0,20,0.000238,6,1,0,1
n1675,disequilibrium,,disequilibrium,disequilibrium,2,6,0,1,1,0,816,0.000088,0,0,1,1
n1676,wattspedrosadejesus2010,,wattspedrosadejesus2010,wattspedrosadejesus2010,2,3,0,1,1,0,817,0.000088,0,0,1,1
n1677,clash,,clash,clash,2,8,1,1,2,0,20,0.000109,3,1,0,1
n1678,overlay,,overlay,overlay,2,8,1,1,2,0,20,0.000144,4,1,0,1
n1679,wattsalsop1995in,,wattsalsop1995in,wattsalsop1995in,2,12,1,1,2,0,20,0.000113,3,1,0,1
n1680,precurser,,precurser,precurser,2,18,0,1,1,0,46,0.000088,5,0,0,0
n1681,acceleration,,acceleration,acceleration,2,1,0,1,1,0,819,0.000088,0,0,0,0
n1682,dissonance,,dissonance,dissonance,2,2,0,1,1,0,821,0.000088,2,0,1,1
n1683,mccormacketal2014,,mccormacketal2014,mccormacketal2014,2,2,1,1,2,0,820,0.000163,2,1,1,2
n1684,chinkayalvizhi2005,,chinkayalvizhi2005,chinkayalvizhi2005,2,2,1,1,2,0,20,0.00017,2,1,0,1
n1685,thorntonbruton2015,,thorntonbruton2015,thorntonbruton2015,4,2,1,2,3,0,20,0.000143,2,0,2,2
n1686,earlyyears,,earlyyears,earlyyears,2,9,1,1,2,0,20,0.000143,6,0,0,0
n1687,reggioemilio,,reggioemilio,reggioemilio,2,3,0,1,1,0,822,0.000088,3,0,1,1
n1688,opinions,,opinions,opinions,6,6,0,3,3,0,824,0.000088,1,0,1,1
n1689,stands,,stands,stands,2,4,0,1,1,0,825,0.000088,8,0,1,1
n1690,paved,,paved,paved,2,4,1,1,2,0,20,0.000102,8,1,1,2
n1691,playground,,playground,playground,2,4,1,1,2,0,20,0.000175,8,1,1,2
n1692,heavy,,heavy,heavy,2,4,1,1,2,0,20,0.000236,8,1,1,2
n1693,spate,,spate,spate,2,4,1,1,2,0,20,0.000289,8,1,0,1
n1694,seriously,,seriously,seriously,2,14,0,1,1,0,826,0.000088,6,0,0,0
n1695,unafraid,,unafraid,unafraid,2,5,0,1,1,0,827,0.000088,3,0,1,1
n1696,ideas2015p17,,ideas2015p17,ideas2015p17,2,9,1,1,2,0,170,0.000144,2,0,0,0
n1697,intervenes,,intervenes,intervenes,2,9,1,1,2,0,20,0.000228,2,0,0,0
n1698,predetermined,,predetermined,predetermined,2,11,1,1,2,0,20,0.000122,0,1,0,1
n1699,expertise,,expertise,expertise,2,7,0,1,1,0,828,0.000088,1,0,1,1
n1700,p86,,p86,p86,1,8,1,0,1,0,490,0.000107,2,1,0,1
n1701,useful,,useful,useful,2,10,0,1,1,0,829,0.000088,2,0,1,1
n1702,furnished,,furnished,furnished,2,8,1,1,2,0,522,0.000107,5,1,0,1
n1705,positively,,positively,positively,2,3,0,1,1,0,832,0.000088,2,0,1,1
n1706,future,,future,future,2,19,0,1,1,0,833,0.000088,0,0,1,1
n1707,conflict,,conflict,conflict,6,18,1,1,2,0,3,0.000327,5,0,0,0
n1708,nrc2000,,nrc2000,nrc2000,2,6,0,1,1,0,834,0.000088,3,0,1,1
n1709,richards1991,,richards1991,richards1991,2,16,0,1,1,0,835,0.000088,6,0,1,1
n1710,yackeletal1990,,yackeletal1990,yackeletal1990,2,5,0,1,1,0,836,0.000088,1,0,1,1
n1711,participative,,participative,participative,2,1,0,1,1,0,837,0.000088,0,0,0,0
n1712,comprehend,,comprehend,comprehend,2,7,1,1,2,0,103,0.000102,0,0,1,1
n1713,heard,,heard,heard,2,14,1,1,2,0,618,0.000123,7,0,0,0
n1714,short,,short,short,2,1,0,1,1,0,838,0.000088,0,0,0,0
n1715,autonomy,,autonomy,autonomy,2,8,0,1,1,0,839,0.000088,0,0,1,1
n1716,firsthand,,firsthand,firsthand,3,14,0,1,1,0,840,0.000088,4,0,0,0
n1717,offers,,offers,offers,2,4,0,1,1,0,841,0.000088,1,0,1,1
n1718,abundant,,abundant,abundant,2,1,0,1,1,0,842,0.000088,0,0,0,0
n1719,higherlevel,,higherlevel,higherlevel,2,1,1,1,2,0,20,0.00014,0,0,0,0
n1720,enthusiastic,,enthusiastic,enthusiastic,2,3,0,1,1,0,844,0.000088,15,0,1,1
n1721,thinker,,thinker,thinker,2,3,1,1,2,0,843,0.000163,15,1,1,2
n1722,accepting,,accepting,accepting,2,6,1,1,2,0,823,0.000113,1,1,1,2
n1723,rationale,,rationale,rationale,2,4,0,1,1,0,846,0.000088,3,0,1,1
n1724,nrc1996nrc2012,,nrc1996nrc2012,nrc1996nrc2012,2,4,1,1,2,0,845,0.000163,3,1,1,2
n1725,bybee1997,,bybee1997,bybee1997,2,11,0,1,1,0,847,0.000088,1,0,1,1
n1726,orgillthomas2007,,orgillthomas2007,orgillthomas2007,2,6,0,1,1,0,848,0.000088,2,0,1,1
n1727,liferelated,,liferelated,liferelated,2,6,0,1,1,0,849,0.000088,0,0,1,1
n1729,error,,error,error,2,1,0,1,1,0,851,0.000088,0,0,0,0
n1730,attempts,,attempts,attempts,2,1,1,1,2,0,850,0.000163,0,0,0,0
n1731,osterman1998p4,,osterman1998p4,osterman1998p4,2,16,0,1,1,0,852,0.000088,7,0,1,1
n1732,past,,past,past,2,7,0,1,1,0,853,0.000088,1,0,1,1
n1733,requiring,,requiring,requiring,2,3,0,1,1,0,854,0.000088,2,0,1,1
n1734,precept,,precept,precept,2,15,0,1,1,0,855,0.000088,2,0,1,1
n1735,constructivity,,constructivity,constructivity,2,15,0,1,1,0,856,0.000088,2,0,1,1
n1736,manipulatives,,manipulatives,manipulatives,2,20,0,1,1,0,857,0.000088,4,0,1,1
n1737,dieness1973,,dieness1973,dieness1973,2,14,1,1,2,0,20,0.000144,2,0,0,0
n1738,36,,36,36,2,1,1,1,2,0,20,0.000105,0,0,0,0
n1739,merged,,merged,merged,2,6,0,1,1,0,858,0.000088,0,0,1,1
n1740,symbolization,,symbolization,symbolization,2,13,1,1,2,0,20,0.000125,8,1,1,2
n1741,fourstage,,fourstage,fourstage,2,2,0,1,1,0,859,0.000088,1,0,1,1
n1742,exercising,,exercising,exercising,2,9,1,1,2,0,8,0.000113,7,0,0,0
n1743,brain,,brain,brain,2,9,1,1,2,0,7,0.000184,7,0,0,0
n1744,executing,,executing,executing,2,6,0,1,1,0,860,0.000088,0,0,1,1
n1745,causes,,causes,causes,2,18,0,1,1,0,47,0.000088,5,0,0,0
