Id,Label,timeset,v_name,indegree,outdegree,Degree,weighted indegree,weighted outdegree,Weighted Degree,Eccentricity,closnesscentrality,harmonicclosnesscentrality,betweenesscentrality,modularity_class,pageranks
n0,practice,,practice,13,11,24,13,14,27,10,0.2511,0.27484,53993.516356,16,0.001428
n1,inquiry,,inquiry,82,100,182,131,131,262,9,0.313247,0.364787,1051634.481906,16,0.014053
n2,think,,think,5,5,10,5,5,10,11,0.195152,0.207327,17628.476503,21,0.000534
n3,pedagogies,,pedagogies,3,3,6,3,3,6,12,0.183507,0.194181,7913.760387,18,0.000333
n4,digital,,digital,7,4,11,7,7,14,11,0.196465,0.209166,13784.927877,21,0.000815
n5,age,,age,4,4,8,4,4,8,11,0.214375,0.228939,6356.362641,8,0.000473
n6,opportunity,,opportunity,2,2,4,2,2,4,10,0.20989,0.222679,2850.213401,8,0.000258
n7,reconsider,,reconsider,1,1,2,1,1,2,10,0.20262,0.21417,20.741513,8,0.000169
n8,basic,,basic,8,5,13,8,8,16,9,0.254006,0.277594,20294.858038,16,0.000931
n9,models,,models,20,22,42,23,23,46,10,0.261374,0.290264,135726.161885,0,0.002484
n10,teaching,,teaching,18,12,30,20,19,39,10,0.260578,0.287355,60159.385343,5,0.002083
n11,learning,,learning,73,83,156,117,118,235,9,0.301444,0.347689,849270.629663,5,0.012154
n12,one,,one,15,16,31,17,17,34,10,0.225421,0.245093,86693.984739,9,0.001998
n13,starting,,starting,3,2,5,3,4,7,11,0.192967,0.203841,1386.098263,18,0.000366
n14,point,,point,6,8,14,8,8,16,11,0.224162,0.242084,34164.887472,18,0.000863
n15,interests,,interests,1,1,2,1,1,2,11,0.171589,0.179513,273.134725,21,0.000151
n16,learner,,learner,8,8,16,8,8,16,10,0.207063,0.221836,24208.579862,21,0.000943
n17,categorized,,categorized,1,1,2,1,1,2,12,0.158714,0.165254,1408.816967,6,0.000159
n18,johndewey,,johndewey,2,2,4,2,2,4,11,0.188588,0.199703,8368.265967,6,0.00035
n19,“the,,“the,2,2,4,2,2,4,11,0.19137,0.203188,1820.970452,1,0.000349
n20,interest,,interest,5,5,10,5,5,10,10,0.22311,0.241246,18267.778896,21,0.000715
n21,conversation,,conversation,1,1,2,1,1,2,11,0.196135,0.206853,170.529752,21,0.00018
n22,communication,,communication,4,5,9,5,5,10,10,0.243875,0.265253,12788.184049,0,0.000663
n23,finding,,finding,5,4,9,5,5,10,11,0.199844,0.211825,7536.378898,12,0.000565
n24,things,,things,6,6,12,8,8,16,10,0.217886,0.234151,14604.268905,12,0.000943
n25,making,,making,8,8,16,11,11,22,10,0.217443,0.23445,36538.108816,12,0.001187
n26,construction,,construction,7,8,15,8,8,16,10,0.259473,0.286249,29901.473809,1,0.000924
n27,artistic,,artistic,1,1,2,1,1,2,12,0.161408,0.167577,2595.310888,1,0.000157
n28,expression”,,expression”,1,1,2,1,1,2,11,0.192403,0.202659,2607.310888,1,0.000192
n29,called,,called,2,2,4,2,2,4,10,0.238131,0.25799,10166.663699,1,0.000332
n30,natural,,natural,8,8,16,10,10,20,10,0.215889,0.233651,18818.994564,23,0.001135
n31,resources,,resources,4,5,9,5,5,10,10,0.205967,0.22018,15816.25228,19,0.000568
n32,uninvested,,uninvested,1,1,2,1,1,2,13,0.148534,0.153626,2585.288031,4,0.000156
n33,capital,,capital,1,1,2,1,1,2,12,0.174374,0.18252,2597.288031,4,0.000191
n34,upon,,upon,7,7,14,7,7,14,11,0.211097,0.226292,28529.316885,4,0.000954
n35,depends,,depends,1,1,2,1,1,2,11,0.200892,0.21247,443.715936,4,0.000175
n36,active,,active,9,8,17,9,9,18,10,0.251272,0.275034,25305.922788,5,0.000985
n37,growth,,growth,1,1,2,1,1,2,13,0.124648,0.127693,5110.83819,20,0.000152
n38,child”,,child”,1,1,2,1,1,2,12,0.142342,0.146616,5122.83819,20,0.000188
n39,dewey1956pp47–48,,dewey1956pp47–48,1,1,2,1,1,2,11,0.165891,0.172443,5134.83819,20,0.000219
n40,dewey,,dewey,3,3,6,3,3,6,10,0.198777,0.210162,11741.281134,20,0.000432
n41,stated,,stated,3,3,6,3,3,6,10,0.242562,0.263469,13648.768718,3,0.000414
n42,similar,,similar,2,2,4,2,2,4,11,0.220808,0.236991,3321.3605,3,0.000304
n43,ideas,,ideas,24,27,51,35,35,70,10,0.277172,0.310457,195695.677224,16,0.003804
n44,process,,process,27,33,60,43,43,86,9,0.283945,0.320274,212459.356161,16,0.004485
n45,form,,form,7,7,14,7,7,14,10,0.256339,0.280683,24604.199619,16,0.00077
n46,stages,,stages,7,7,14,7,7,14,10,0.238728,0.259893,28755.761677,16,0.000799
n47,reflective,,reflective,4,4,8,4,4,8,11,0.216417,0.231748,10059.876237,3,0.000498
n48,action,,action,7,6,13,7,7,14,10,0.244991,0.267372,27479.221747,7,0.00076
n49,dewey1910,,dewey1910,1,1,2,1,1,2,11,0.194104,0.204708,72.9797,7,0.000151
n50,definition,,definition,4,3,7,5,5,10,10,0.240765,0.261642,11719.107324,16,0.000647
n51,latter,,latter,2,2,4,2,2,4,12,0.16387,0.170979,11019.744386,13,0.000243
n52,uses,,uses,3,4,7,4,4,8,11,0.195092,0.206812,10845.327647,11,0.00051
n53,idea,,idea,5,5,10,5,5,10,10,0.239865,0.260338,26505.714627,16,0.000676
n54,situation,,situation,4,7,11,7,7,14,10,0.219075,0.236083,21489.438937,15,0.000854
n55,provide,,provide,7,6,13,7,7,14,10,0.23263,0.252404,17408.032534,15,0.000803
n56,descriptive,,descriptive,2,2,4,2,2,4,11,0.186262,0.196523,5705.323873,15,0.000311
n57,account,,account,2,4,6,4,4,8,11,0.221838,0.238005,14327.20302,15,0.000482
n58,survive,,survive,1,1,2,1,1,2,11,0.194472,0.20651,360.673584,15,0.000161
n59,world,,world,15,18,33,26,26,52,10,0.241308,0.266306,68851.479725,12,0.002636
n60,“inquiry,,“inquiry,1,1,2,1,1,2,12,0.168847,0.175719,805.079002,15,0.000145
n61,controlled,,controlled,2,2,4,2,2,4,11,0.203068,0.215047,3451.408169,15,0.000292
n62,directed,,directed,3,3,6,3,3,6,10,0.206116,0.218618,10881.951194,15,0.00045
n63,transformation,,transformation,1,1,2,1,1,2,12,0.152422,0.157942,90.554444,15,0.000186
n64,indeterminate,,indeterminate,4,1,5,4,4,8,11,0.179756,0.188719,6853.920996,15,0.000551
n65,determinate,,determinate,1,1,2,1,1,2,14,0.122082,0.125012,5192.708333,1,0.000159
n66,constituent,,constituent,1,1,2,1,1,2,13,0.139006,0.14307,5204.708333,1,0.000194
n67,distinctions,,distinctions,1,1,2,1,1,2,12,0.161377,0.167513,5216.708333,1,0.000224
n68,relations,,relations,3,3,6,3,3,6,11,0.192331,0.202788,23162.326655,1,0.000438
n69,convert,,convert,1,1,2,1,1,2,11,0.194354,0.204907,791.044271,1,0.000183
n70,elements,,elements,4,4,8,4,4,8,10,0.241149,0.262011,14151.79634,1,0.000582
n71,original,,original,2,2,4,2,2,4,11,0.197751,0.209831,1039.471034,1,0.000286
n72,unified,,unified,2,2,4,2,2,4,12,0.162758,0.169653,6273.439267,7,0.00029
n73,whole”,,whole”,1,1,2,1,1,2,14,0.123735,0.126938,2575.658255,0,0.000182
n74,dewey1991p108,,dewey1991p108,1,1,2,1,1,2,13,0.141153,0.145689,2587.658255,0,0.000214
n75,inspired,,inspired,2,2,4,2,2,4,12,0.164278,0.171374,8616.461924,0,0.000336
n76,sources,,sources,1,1,2,1,1,2,11,0.182438,0.190933,2979.702104,0,0.000202
n77,fundamental,,fundamental,3,3,6,3,3,6,10,0.223033,0.23886,12079.346565,0,0.000478
n78,begins,,begins,4,4,8,4,4,8,11,0.186723,0.19744,12504.377982,15,0.000449
n79,curiosity,,curiosity,9,10,19,10,10,20,10,0.219038,0.235858,32883.632407,5,0.001152
n80,spiral,,spiral,1,1,2,1,1,2,11,0.198654,0.209512,390.075646,21,0.000159
n81,path,,path,5,5,10,5,5,10,10,0.247805,0.269685,15911.288602,1,0.000605
n82,envisioned,,envisioned,1,1,2,1,1,2,11,0.195538,0.206162,113.900366,12,0.00015
n83,asking,,asking,11,4,15,12,12,24,10,0.242998,0.264207,30210.303572,12,0.001348
n84,questions,,questions,36,45,81,53,52,105,9,0.276218,0.312677,287198.584008,12,0.00585
n85,investigating,,investigating,4,4,8,4,4,8,11,0.20238,0.215395,9046.510888,12,0.000502
n86,solutions,,solutions,5,5,10,5,5,10,11,0.218702,0.234678,13874.516139,12,0.000624
n87,creating,,creating,2,2,4,3,3,6,11,0.202348,0.21512,1435.454749,12,0.000356
n88,discussing,,discussing,6,6,12,6,6,12,10,0.241127,0.262655,16144.700354,12,0.000684
n89,discoveries,,discoveries,1,1,2,1,1,2,10,0.218108,0.233606,229.014011,12,0.000156
n90,experiences,,experiences,35,41,76,47,46,93,9,0.278827,0.314737,326449.130542,5,0.005117
n91,reflecting,,reflecting,3,3,6,3,3,6,11,0.22007,0.235847,6538.103059,12,0.000354
n92,newfound,,newfound,1,1,2,1,1,2,10,0.218163,0.23366,465.049928,12,0.000159
n93,knowledge,,knowledge,35,48,83,51,51,102,9,0.278918,0.315232,275921.484288,11,0.005607
n94,followed,,followed,3,3,6,3,3,6,10,0.21336,0.227973,2344.689055,21,0.000343
n95,new,,new,35,25,60,37,37,74,10,0.278193,0.310017,241893.900942,11,0.004202
n96,brucebishop2002,,brucebishop2002,1,1,2,1,1,2,11,0.185804,0.195835,359.851748,12,0.000155
n97,step,,step,4,4,8,4,4,8,10,0.228125,0.247366,16955.198554,16,0.000505
n98,naturally,,naturally,1,1,2,1,1,2,10,0.193767,0.204573,297.129284,5,0.000148
n99,leads,,leads,5,5,10,5,5,10,9,0.240247,0.261843,19533.819144,5,0.000593
n100,next,,next,6,5,11,6,6,12,10,0.233901,0.253307,21474.00346,22,0.000842
n101,inspiring,,inspiring,1,1,2,1,1,2,11,0.217719,0.231856,535.047016,22,0.000178
n102,investigations,,investigations,9,9,18,10,10,20,10,0.22255,0.240114,36875.504716,13,0.00119
n103,opportunities,,opportunities,9,10,19,11,11,22,10,0.246852,0.270136,43772.615468,13,0.001197
n104,authentic,,authentic,4,5,9,6,6,12,10,0.245977,0.267971,8976.129515,5,0.000656
n105,“teachable”,,“teachable”,1,1,2,1,1,2,12,0.159503,0.16566,2560.46606,12,0.000152
n106,moments,,moments,1,1,2,1,1,2,11,0.189688,0.200114,2572.46606,12,0.000188
n107,question,,question,20,16,36,20,19,39,10,0.233965,0.255287,106120.495554,12,0.002451
n108,exploration,,exploration,10,10,20,12,12,24,10,0.216764,0.233607,33464.996407,5,0.001336
n109,turn,,turn,2,2,4,2,2,4,10,0.197447,0.209605,1392.490192,5,0.000251
n110,investigate,,investigate,6,6,12,6,6,12,10,0.221093,0.237629,15015.395581,21,0.000702
n111,brucedavidson1996,,brucedavidson1996,1,1,2,1,1,2,11,0.202716,0.215139,169.845841,18,0.000158
n112,thus,,thus,13,13,26,13,13,26,10,0.254157,0.280271,71335.451964,18,0.001548
n113,reflection,,reflection,8,8,16,8,8,16,10,0.229634,0.248858,29575.548232,7,0.000937
n114,solving,,solving,4,6,10,6,6,12,10,0.230956,0.249765,14307.004824,12,0.000689
n115,problem,,problem,11,12,23,13,14,27,10,0.222434,0.24129,37397.313035,12,0.001592
n116,may,,may,15,14,29,16,16,32,10,0.228307,0.249194,63402.081963,21,0.001675
n117,lead,,lead,5,5,10,5,5,10,10,0.236225,0.257147,14536.064229,21,0.000522
n118,reformulating,,reformulating,1,1,2,1,1,2,11,0.181999,0.191594,214.76561,12,0.000148
n119,posing,,posing,2,2,4,2,2,4,11,0.217812,0.232245,4906.12465,15,0.00025
n120,similarly,,similarly,4,4,8,4,4,8,11,0.212126,0.226664,22621.366781,7,0.000491
n121,closely,,closely,2,2,4,2,2,4,12,0.17565,0.184336,3224.87816,19,0.00023
n122,tied,,tied,1,1,2,1,1,2,11,0.193025,0.203857,771.470622,19,0.000157
n123,dialogue,,dialogue,6,4,10,6,5,11,10,0.239084,0.260516,16392.122383,21,0.000714
n124,others,,others,11,13,24,13,13,26,9,0.25456,0.281106,41367.491301,16,0.001539
n125,cycle,,cycle,5,15,20,16,16,32,10,0.240788,0.264172,40497.08849,5,0.001589
n126,presents,,presents,2,2,4,2,2,4,11,0.207498,0.220429,435.080033,12,0.000239
n127,aspects,,aspects,7,4,11,7,7,14,10,0.242333,0.263505,28434.794505,16,0.000847
n128,need,,need,11,11,22,11,11,22,11,0.224633,0.244242,57476.51192,8,0.001494
n129,support,,support,19,18,37,19,20,39,10,0.264116,0.293083,126445.782401,5,0.002137
n130,successful,,successful,1,1,2,1,1,2,10,0.231685,0.250087,0,5,0.00015
n131,environment,,environment,4,6,10,7,7,14,10,0.233031,0.25275,26355.133555,5,0.000754
n132,serves,,serves,1,1,2,1,1,2,13,0.130342,0.133796,2560.589826,9,0.00015
n133,boundary,,boundary,1,1,2,1,1,2,12,0.149816,0.154822,2572.589826,9,0.000187
n134,object,,object,2,2,4,2,2,4,11,0.176132,0.184195,9237.166292,9,0.000311
n135,stargriesmer1989,,stargriesmer1989,1,1,2,1,1,2,11,0.171211,0.178385,342.784443,9,0.000191
n136,allowing,,allowing,3,3,6,3,3,6,10,0.206497,0.219257,6815.512526,9,0.000411
n137,us,,us,4,4,8,5,5,10,10,0.242539,0.263555,12229.570664,21,0.00062
n138,relate,,relate,2,2,4,2,2,4,10,0.225204,0.241958,2743.979664,16,0.000267
n139,theory,,theory,5,7,12,7,7,14,10,0.24862,0.272336,23511.427393,16,0.000778
n140,ordinary,,ordinary,1,1,2,1,1,2,10,0.207986,0.221706,74.147443,16,0.000153
n141,practices,,practices,24,26,50,29,29,58,9,0.262496,0.292602,161936.497027,16,0.003223
n142,look,,look,2,2,4,2,2,4,11,0.181471,0.19062,935.688608,23,0.000261
n143,across,,across,8,7,15,8,8,16,10,0.214,0.229841,34372.721577,2,0.001109
n144,modes,,modes,2,2,4,2,2,4,11,0.204312,0.217728,2101.892392,16,0.000271
n145,contexts,,contexts,6,10,16,10,10,20,10,0.234392,0.25545,32191.267889,3,0.001041
n146,can,,can,29,33,62,38,39,77,9,0.249393,0.277937,206837.998966,21,0.003964
n147,used,,used,17,19,36,23,23,46,10,0.25216,0.278093,111731.243943,21,0.002575
n148,inform,,inform,1,1,2,1,1,2,11,0.177839,0.185995,612.709705,1,0.000154
n149,guide,,guide,4,4,8,4,4,8,10,0.216234,0.231214,14880.152101,1,0.000488
n150,educational,,educational,8,7,15,10,10,20,10,0.240382,0.261612,21895.911892,3,0.001019
n151,learners,,learners,12,12,24,12,12,24,10,0.234864,0.256466,54302.612776,23,0.001383
n152,important,,important,14,14,28,14,14,28,10,0.243044,0.266272,70973.509385,1,0.001775
n153,note,,note,1,1,2,1,1,2,13,0.128041,0.131469,265.060159,4,0.000167
n154,merely,,merely,2,2,4,2,2,4,12,0.146785,0.151831,11527.902524,4,0.000292
n155,suggestive,,suggestive,1,1,2,1,1,2,12,0.163713,0.170138,3761.815383,4,0.000183
n156,neither,,neither,2,2,4,2,2,4,11,0.195702,0.206668,15712.938881,4,0.000323
n157,sole,,sole,1,1,2,1,1,2,14,0.130151,0.133621,7662,4,0.000196
n158,complete,,complete,1,1,2,1,1,2,13,0.149554,0.154543,7674,4,0.000226
n159,rigid,,rigid,1,1,2,1,1,2,12,0.175758,0.183617,7686,4,0.000251
n160,characterization,,characterization,1,1,2,1,1,2,11,0.213094,0.22714,7698,4,0.000272
n161,inquirybased,,inquirybased,40,17,57,47,48,95,10,0.270572,0.301361,241004.253413,5,0.00541
n162,actuality,,actuality,1,1,2,1,1,2,10,0.238573,0.258544,0,5,0.000146
n163,rarely,,rarely,1,1,2,1,1,2,11,0.181113,0.189829,178.739464,5,0.00015
n164,proceeds,,proceeds,2,2,4,2,2,4,10,0.221093,0.237298,3545.14418,5,0.000274
n165,simple,,simple,8,7,15,8,8,16,10,0.212829,0.228553,29782.838235,15,0.001031
n166,linear,,linear,3,3,6,3,3,6,11,0.20895,0.223107,9798.187452,11,0.000423
n167,fashion,,fashion,1,1,2,1,1,2,12,0.175087,0.182868,121.512145,16,0.000179
n168,five,,five,4,4,8,4,4,8,11,0.212144,0.226284,10037.97035,16,0.000482
n169,dimensions,,dimensions,5,5,10,5,5,10,10,0.240472,0.261974,15181.950758,16,0.000611
n170,process—ask,,process—ask,1,1,2,1,1,2,11,0.181113,0.189884,52.303121,16,0.000163
n171,create,,create,7,8,15,8,8,16,10,0.215093,0.231439,31403.668335,21,0.000988
n172,discuss,,discuss,4,4,8,4,4,8,10,0.207801,0.221045,7547.094438,14,0.000464
n173,reflect—overlap,,reflect—overlap,1,1,2,1,1,2,11,0.197084,0.208136,174.450659,14,0.000158
n174,every,,every,7,7,14,7,7,14,10,0.245366,0.26765,25892.693081,14,0.000767
n175,category,,category,2,2,4,2,2,4,11,0.186006,0.19638,7902.352109,2,0.00025
n176,present,,present,2,2,4,2,2,4,11,0.199782,0.211531,2701.948645,7,0.000228
n177,given,,given,6,6,12,6,6,12,10,0.249272,0.27246,29553.656728,8,0.000694
n178,embedded,,embedded,2,2,4,2,2,4,10,0.203213,0.216173,4147.96405,15,0.00024
n179,fact,,fact,3,3,6,3,3,6,10,0.225917,0.243564,3536.924657,16,0.000383
n180,nature,,nature,6,4,10,6,6,12,9,0.258506,0.283512,12143.419711,16,0.000712
n181,steps,,steps,6,6,12,6,6,12,10,0.227277,0.246077,18106.790025,21,0.000705
n182,mutually,,mutually,1,1,2,1,1,2,12,0.15592,0.161703,1898.812149,6,0.000159
n183,reinforcing,,reinforcing,2,2,4,2,2,4,11,0.184655,0.194323,5325.266034,6,0.000304
n184,interrelated,,interrelated,1,1,2,1,1,2,13,0.142051,0.146641,54.503755,6,0.000188
n185,despite,,despite,2,2,4,2,2,4,12,0.165485,0.172674,8158.595104,6,0.000334
n186,complexities,,complexities,1,1,2,1,1,2,11,0.194134,0.205476,4523.393722,6,0.000201
n187,highlights,,highlights,2,2,4,2,2,4,11,0.196571,0.207729,2727.81693,24,0.000252
n188,otherwise,,otherwise,1,1,2,1,1,2,11,0.181202,0.189762,2555,16,0.000162
n189,opaque,,opaque,1,1,2,1,1,2,10,0.221227,0.236953,2567,16,0.000196
n190,“ask”,,“ask”,1,1,2,1,1,2,11,0.195077,0.206478,927.722267,21,0.000148
n191,dimension,,dimension,11,11,22,12,12,24,10,0.242287,0.265496,62347.987839,21,0.00154
n192,reminds,,reminds,2,1,3,2,2,4,11,0.195241,0.205849,281.680866,21,0.000241
n193,develops,,develops,4,4,8,4,4,8,10,0.230583,0.249669,10169.877011,16,0.000453
n194,arising,,arising,2,2,4,2,2,4,11,0.200062,0.212986,1378.217448,12,0.000251
n195,experience,,experience,22,23,45,23,23,46,10,0.240562,0.265622,142364.468596,23,0.002636
n196,meaningful,,meaningful,11,10,21,12,12,24,10,0.254333,0.279471,62010.336831,3,0.00133
n197,genuine,,genuine,2,2,4,2,2,4,11,0.19042,0.201506,7978.34948,0,0.000305
n198,realworld,,realworld,1,1,2,1,1,2,10,0.218108,0.233606,1258.056851,5,0.000157
n199,challenges,,challenges,1,1,2,1,1,2,12,0.152413,0.157932,772.305275,15,0.000153
n200,refers,,refers,3,3,6,3,3,6,11,0.200109,0.212388,10313.590668,17,0.000402
n201,part,,part,8,7,15,8,8,16,11,0.21975,0.236692,31812.960181,16,0.000955
n202,including,,including,6,7,13,7,7,14,10,0.230231,0.248913,25247.952282,21,0.00075
n203,individual’s,,individual’s,1,1,2,1,1,2,11,0.188726,0.199106,254.218531,23,0.00015
n204,participation,,participation,11,13,24,13,13,26,10,0.232546,0.253371,46323.134181,23,0.001487
n205,community,,community,7,7,14,8,8,16,10,0.212179,0.227519,25687.70491,14,0.000947
n206,something,,something,2,2,4,2,2,4,10,0.206963,0.221457,3687.621438,12,0.000297
n207,delivered,,delivered,2,2,4,2,2,4,12,0.16836,0.176109,4353.313245,11,0.000239
n208,“outside”,,“outside”,1,1,2,1,1,2,11,0.18874,0.199119,1113.678956,23,0.00016
n209,example,,example,2,2,4,2,2,4,12,0.172801,0.181085,1941.605891,14,0.000257
n210,comes,,comes,3,3,6,3,3,6,11,0.205046,0.217888,10377.285661,14,0.000397
n211,early,,early,28,11,39,30,30,60,10,0.256903,0.28259,117510.340802,18,0.003343
n212,study,,study,16,16,32,18,17,35,9,0.263412,0.292008,85405.259799,7,0.002066
n213,computers,,computers,2,2,4,2,2,4,11,0.181818,0.191745,3804.770704,10,0.000255
n214,researchers,,researchers,3,3,6,3,3,6,11,0.20368,0.216169,8906.35167,10,0.000401
n215,found,,found,5,5,10,5,5,10,10,0.24802,0.27096,21527.025072,21,0.00064
n216,students,,students,40,47,87,54,54,108,9,0.277862,0.313512,320687.899496,21,0.005888
n217,became,,became,1,1,2,1,1,2,11,0.192923,0.203638,185.190408,7,0.000152
n218,engaged,,engaged,6,7,13,7,7,14,10,0.238995,0.26035,17495.234517,7,0.000804
n219,bug,,bug,2,2,4,2,2,4,11,0.197934,0.209861,1482.943751,12,0.00027
n220,computer,,computer,4,4,8,4,4,8,10,0.232398,0.251628,18554.092326,11,0.000514
n221,software,,software,2,2,4,2,2,4,12,0.162727,0.169915,5709.222672,3,0.000243
n222,exploring,,exploring,7,7,14,7,7,14,10,0.219038,0.236292,20598.523648,12,0.000851
n223,behavior,,behavior,3,3,6,3,3,6,11,0.199767,0.211545,6207.533698,12,0.0004
n224,led,,led,4,4,8,4,4,8,10,0.22947,0.248112,7932.26186,21,0.000453
n225,deep,,deep,2,2,4,2,2,4,10,0.239351,0.259735,3339.799608,21,0.000247
n226,programming,,programming,1,1,2,1,1,2,12,0.169259,0.176352,2701.756628,10,0.00015
n227,noted,,noted,1,1,2,1,1,2,12,0.156461,0.162323,2568.549242,10,0.000173
n228,“enormous,,“enormous,1,1,2,1,1,2,11,0.185402,0.195055,2580.549242,10,0.000206
n229,pedagogical,,pedagogical,4,4,8,4,4,8,10,0.227478,0.246043,17339.050348,18,0.000519
n230,difference,,difference,1,1,2,1,1,2,14,0.121041,0.123969,7662,12,0.000169
n231,answering,,answering,1,1,2,1,1,2,13,0.13765,0.141714,7674,12,0.000203
n232,someone,,someone,1,1,2,1,1,2,12,0.159543,0.165682,7686,12,0.000231
n233,else’s,,else’s,1,1,2,1,1,2,11,0.189716,0.200126,7698,12,0.000256
n234,formulating,,formulating,3,3,6,3,3,6,11,0.220638,0.236451,7839.49936,12,0.000357
n235,own”,,own”,1,1,2,1,1,2,12,0.163671,0.170297,2572.088528,12,0.00016
n236,oldsschwartzwillie1980p40,,oldsschwartzwillie1980p40,1,1,2,1,1,2,11,0.195612,0.206923,2584.088528,12,0.000195
n237,caution,,caution,1,1,2,1,1,2,10,0.238617,0.258596,1372.853196,1,0.000167
n238,always,,always,3,3,6,3,3,6,11,0.173244,0.18209,10157.656859,15,0.000413
n239,start,,start,3,3,6,3,3,6,11,0.189381,0.199948,5996.148517,15,0.000384
n240,wellarticulated,,wellarticulated,1,1,2,1,1,2,11,0.189674,0.200104,691.781576,15,0.000168
n241,arise,,arise,1,2,3,2,2,4,11,0.188132,0.198254,2891.40593,12,0.00025
n242,elspethhuxley1959,,elspethhuxley1959,1,1,2,1,1,2,11,0.19527,0.205836,311.736583,3,0.00016
n243,well,,well,10,10,20,10,10,20,10,0.226036,0.244991,41713.845424,3,0.001239
n244,best,,best,5,5,10,5,5,10,10,0.215853,0.23166,13765.454972,3,0.000642
n245,way,,way,7,7,14,7,7,14,9,0.22902,0.247495,16883.069139,3,0.000809
n246,find,,find,2,2,4,2,2,4,11,0.195077,0.206438,1314.363231,12,0.000258
n247,ask,,ask,5,5,10,6,6,12,10,0.226216,0.245038,13062.550985,12,0.000696
n248,fire,,fire,1,1,2,1,1,2,11,0.189646,0.200072,491.825239,12,0.000155
n249,like,,like,5,5,10,7,7,14,10,0.224103,0.240117,32106.553155,2,0.000778
n250,firing,,firing,1,1,2,1,1,2,16,0.103344,0.105478,7662,23,0.000153
n251,gun—bang,,gun—bang,1,1,2,1,1,2,15,0.115209,0.117921,7674,23,0.000189
n252,goes,,goes,1,1,2,1,1,2,14,0.130151,0.133822,7686,23,0.00022
n253,everything,,everything,1,1,2,1,1,2,13,0.149546,0.154928,7698,23,0.000246
n254,takes,,takes,4,3,7,5,5,10,12,0.175734,0.184588,28279.902353,23,0.00067
n255,flight,,flight,1,1,2,1,1,2,16,0.09974,0.101682,10214.833333,8,0.000173
n256,runs,,runs,1,1,2,1,1,2,15,0.110747,0.113161,10226.833333,8,0.000206
n257,shelter,,shelter,1,1,2,1,1,2,14,0.124485,0.127661,10238.833333,8,0.000234
n258,sit,,sit,1,1,2,1,1,2,13,0.142114,0.146597,10250.833333,8,0.000258
n259,quite,,quite,1,1,2,1,1,2,12,0.16556,0.172489,10262.833333,8,0.000278
n260,still,,still,4,4,8,4,4,8,11,0.198271,0.210501,21687.477734,8,0.000638
n261,pretend,,pretend,2,2,4,2,2,4,11,0.190363,0.20105,7179.781301,8,0.000288
n262,looking,,looking,3,3,6,5,5,10,11,0.186235,0.196497,10782.186029,12,0.000578
n263,little,,little,2,2,4,2,2,4,12,0.174303,0.183246,3081.276109,2,0.000335
n264,facts,,facts,2,2,4,2,2,4,11,0.178594,0.187928,8715.067625,2,0.000293
n265,will,,will,10,10,20,10,10,20,10,0.214321,0.23097,52269.81823,13,0.001307
n266,come,,come,4,4,8,4,4,8,11,0.221781,0.237983,17030.058528,20,0.000526
n267,peck,,peck,1,1,2,1,1,2,14,0.125232,0.128581,5110.125,20,0.000171
n268,round,,round,1,1,2,1,1,2,13,0.14312,0.14789,5122.125,20,0.000204
n269,feet,,feet,1,1,2,1,1,2,12,0.16697,0.17441,5134.125,20,0.000232
n270,situations,,situations,3,4,7,5,5,10,11,0.200359,0.213645,22300.832552,11,0.000653
n271,venture,,venture,1,1,2,1,1,2,14,0.115478,0.118178,7662,13,0.00017
n272,forth,,forth,1,1,2,1,1,2,13,0.130528,0.1342,7674,13,0.000203
n273,thickets,,thickets,1,1,2,1,1,2,12,0.150088,0.155471,7686,13,0.000232
n274,intentions,,intentions,1,1,2,1,1,2,11,0.176543,0.185272,7698,13,0.000256
n275,creep,,creep,1,1,2,1,1,2,14,0.129658,0.133091,5121.466399,13,0.00017
n276,sun,,sun,1,1,2,1,1,2,13,0.148939,0.153899,5133.466399,13,0.000203
n277,stone,,stone,1,1,2,1,1,2,12,0.174956,0.182816,5145.466399,13,0.000232
n278,patient,,patient,2,2,4,2,2,4,11,0.211986,0.226207,8795.955678,13,0.000364
n279,see,,see,7,7,14,9,9,18,10,0.220033,0.237398,30856.665175,9,0.000934
n280,understand,,understand,7,10,17,10,11,21,9,0.256877,0.281129,28499.034446,21,0.001151
n281,great,,great,2,2,4,2,2,4,12,0.180248,0.188821,802.630208,24,0.00026
n282,deal,,deal,3,3,6,3,3,6,11,0.218219,0.232916,21342.366422,24,0.000342
n283,man,,man,1,1,2,1,1,2,14,0.123207,0.12635,7662,24,0.000156
n284,gun,,gun,1,1,2,1,1,2,13,0.140466,0.144862,7674,24,0.000191
n285,p272,,p272,1,1,2,1,1,2,12,0.163348,0.170035,7686,24,0.000222
n286,“investigate”,,“investigate”,1,1,2,1,1,2,11,0.195137,0.206527,7698,24,0.000247
n287,relates,,relates,1,1,2,1,1,2,12,0.162501,0.169411,2627.856421,23,0.000168
n288,varieties,,varieties,1,1,2,1,1,2,11,0.193972,0.205878,2639.856421,23,0.000202
n289,possible,,possible,7,7,14,7,7,14,11,0.205654,0.220694,39964.451751,10,0.000846
n290,many,,many,8,8,16,8,8,16,11,0.227317,0.246737,32755.521015,12,0.001068
n291,ways,,ways,11,12,23,12,12,24,10,0.228368,0.248764,42692.826181,11,0.001545
n292,become,,become,5,5,10,5,5,10,10,0.242447,0.263301,23250.027338,0,0.000649
n293,suggests,,suggests,4,5,9,5,5,10,11,0.220259,0.238114,13918.801158,16,0.000586
n294,require,,require,2,2,4,2,2,4,11,0.188643,0.198497,6913.566793,5,0.000285
n295,diverse,,diverse,2,2,4,2,2,4,10,0.208611,0.221623,1821.406758,5,0.000275
n296,challenging,,challenging,5,5,10,5,5,10,10,0.233667,0.2525,9803.132547,12,0.00061
n297,materials,,materials,5,6,11,6,6,12,10,0.23131,0.251062,16320.677748,5,0.000741
n298,problems,,problems,14,13,27,15,15,30,10,0.240946,0.263099,62320.590329,12,0.001686
n299,includes,,includes,6,6,12,6,6,12,10,0.239865,0.26004,21483.19924,11,0.000719
n300,interactions,,interactions,6,6,12,6,6,12,10,0.231435,0.249563,22596.308879,11,0.000794
n301,also,,also,22,26,48,26,26,52,10,0.242814,0.267283,146577.114557,21,0.002813
n302,moral,,moral,1,1,2,1,1,2,11,0.195077,0.206478,1394.143552,21,0.000151
n303,physical,,physical,5,6,11,6,6,12,10,0.22477,0.242742,21236.753782,11,0.000685
n304,emotional,,emotional,2,2,4,2,2,4,12,0.159365,0.165866,8519.088114,5,0.000284
n305,aesthetic,,aesthetic,1,1,2,1,1,2,12,0.162552,0.169063,1436.699311,5,0.000179
n306,practical,,practical,2,2,4,2,2,4,11,0.194016,0.205086,8313.388468,16,0.000358
n307,inherent,,inherent,2,2,4,2,2,4,10,0.249927,0.273038,1387.51021,16,0.000255
n308,enhancements,,enhancements,1,1,2,1,1,2,12,0.164289,0.170807,5222.087141,4,0.000183
n309,addons,,addons,1,1,2,1,1,2,11,0.196511,0.207602,5234.087141,4,0.000214
n310,investigation,,investigation,11,11,22,11,11,22,10,0.244455,0.267038,61113.352835,16,0.001255
n311,gather,,gather,5,3,8,6,6,12,11,0.216107,0.232009,6466.565176,0,0.00065
n312,information,,information,8,9,17,9,9,18,10,0.238773,0.261355,44124.441881,0,0.001169
n313,craft,,craft,1,1,2,1,1,2,12,0.166407,0.173827,752.895044,7,0.000162
n314,experiment,,experiment,5,5,10,5,5,10,11,0.199549,0.21281,24817.077744,7,0.000865
n315,observe,,observe,5,6,11,6,6,12,10,0.231581,0.252046,28575.231724,13,0.000746
n316,interview,,interview,2,2,4,2,2,4,10,0.218293,0.234769,4267.34993,13,0.000301
n317,recast,,recast,1,1,2,1,1,2,11,0.189646,0.200072,492.941371,12,0.000148
n318,refine,,refine,1,1,2,1,1,2,13,0.135151,0.138997,9379.489029,9,0.000169
n319,line,,line,2,2,4,2,2,4,12,0.156223,0.162038,10255.07619,9,0.00034
n320,query,,query,1,1,2,1,1,2,12,0.178867,0.186679,5575.125759,9,0.000203
n321,plunge,,plunge,1,1,2,1,1,2,11,0.217738,0.231869,5587.125759,9,0.000232
n322,anticipate,,anticipate,1,1,2,1,1,2,13,0.135887,0.140319,2682.645565,8,0.000169
n323,informationgathering,,informationgathering,1,1,2,1,1,2,12,0.157189,0.163967,2694.645565,8,0.000202
n324,stage,,stage,6,6,12,6,6,12,11,0.186411,0.198313,25232.887506,8,0.000779
n325,becomes,,becomes,3,3,6,3,3,6,11,0.196736,0.208486,10943.200531,14,0.000356
n326,selfmotivated,,selfmotivated,1,1,2,1,1,2,10,0.221227,0.236953,1315.944301,14,0.00016
n327,owned,,owned,1,1,2,1,1,2,11,0.192923,0.203638,160.195009,7,0.000148
n328,“create”,,“create”,1,1,2,1,1,2,11,0.195107,0.20651,629.644847,21,0.000159
n329,picks,,picks,1,1,2,1,1,2,12,0.14605,0.150593,2579.818182,15,0.000168
n330,“controlled,,“controlled,1,1,2,1,1,2,11,0.170961,0.178024,2591.818182,15,0.000202
n331,transformation”,,transformation”,1,1,2,1,1,2,12,0.180223,0.189089,161.99261,15,0.000186
n332,dewey’s,,dewey’s,1,1,2,2,2,4,11,0.194104,0.204708,95.800435,16,0.000262
n333,term,,term,2,3,5,2,3,5,10,0.238728,0.259161,4231.786806,21,0.000257
n334,means,,means,6,6,12,6,6,12,10,0.231247,0.250132,21581.201443,5,0.000816
n335,handson,,handson,8,4,12,8,8,16,10,0.246189,0.268787,21895.890908,5,0.000962
n336,implies,,implies,2,2,4,2,2,4,11,0.210113,0.224301,341.793894,18,0.000253
n337,creation,,creation,1,1,2,1,1,2,11,0.173046,0.180774,158.328737,5,0.000152
n338,meaning,,meaning,5,5,10,5,5,10,10,0.209189,0.223296,20467.098504,16,0.000683
n339,forms,,forms,7,7,14,7,7,14,10,0.228246,0.246256,28626.070667,11,0.000921
n340,collaborating,,collaborating,1,1,2,1,1,2,11,0.217682,0.231804,0,11,0.000171
n341,roles,,roles,2,2,4,2,2,4,11,0.208104,0.220809,3837.20379,14,0.000266
n342,collaborators,,collaborators,1,1,2,1,1,2,11,0.192822,0.204087,127.038144,14,0.000172
n343,coalesce,,coalesce,1,1,2,1,1,2,11,0.1716,0.179526,213.348247,15,0.000154
n344,makes,,makes,5,5,10,5,5,10,11,0.219788,0.236234,21350.361416,12,0.000601
n345,connections,,connections,4,4,8,4,4,8,11,0.206847,0.220473,7221.188565,12,0.000443
n346,ability,,ability,6,7,13,7,7,14,10,0.221227,0.238011,19805.899452,21,0.000707
n347,synthesize,,synthesize,1,1,2,1,1,2,11,0.173057,0.180787,591.541443,8,0.000169
n348,creative,,creative,4,4,8,4,4,8,11,0.206963,0.221066,14681.473461,16,0.000527
n349,spark,,spark,1,1,2,1,1,2,11,0.185912,0.195217,268.097792,11,0.000171
n350,now,,now,4,4,8,4,4,8,11,0.202253,0.214992,8861.207622,21,0.000439
n351,undertakes,,undertakes,1,1,2,1,1,2,12,0.171532,0.179285,857.400573,16,0.000152
n352,task,,task,6,5,11,6,6,12,11,0.19636,0.208664,12572.093121,14,0.000711
n353,shaping,,shaping,2,2,4,2,2,4,12,0.184126,0.193233,5593.790684,16,0.000291
n354,significant,,significant,2,2,4,2,2,4,11,0.220903,0.235928,6630.090591,16,0.000276
n355,thoughts,,thoughts,2,2,4,2,2,4,11,0.217443,0.232554,4100.044327,11,0.000305
n356,theories,,theories,5,7,12,7,7,14,10,0.219113,0.2365,15262.224718,16,0.000753
n357,extending,,extending,3,3,6,3,3,6,11,0.211011,0.225368,13211.550674,6,0.000387
n358,hisher,,hisher,2,2,4,2,2,4,10,0.215527,0.230186,3899.826554,6,0.000304
n359,prior,,prior,8,5,13,8,8,16,10,0.237712,0.258825,42032.354511,11,0.000998
n360,“discuss”,,“discuss”,1,1,2,1,1,2,11,0.195092,0.206497,1254.059092,21,0.000156
n361,implicit,,implicit,2,2,4,2,2,4,12,0.182399,0.191938,5430.435035,24,0.000321
n362,although,,although,2,2,4,2,2,4,10,0.239798,0.260368,2073.223987,16,0.000265
n363,personal,,personal,3,2,5,3,3,6,10,0.22311,0.239615,2648.998833,5,0.000324
n364,aspect,,aspect,3,3,6,3,3,6,10,0.243782,0.265323,3997.175048,12,0.000334
n365,social,,social,11,11,22,12,12,24,10,0.228694,0.247898,46342.292328,23,0.001344
n366,arrangements,,arrangements,1,1,2,1,1,2,11,0.175111,0.183356,221.886962,23,0.000154
n367,involves,,involves,11,11,22,11,11,22,9,0.26298,0.289168,46145.803865,16,0.001333
n368,listening,,listening,1,1,2,1,1,2,10,0.202956,0.215573,343.340617,16,0.000162
n369,articulating,,articulating,3,3,6,3,3,6,11,0.205309,0.217659,3915.843641,16,0.000347
n370,understandings,,understandings,8,8,16,9,9,18,10,0.251913,0.275324,23472.226266,20,0.001065
n371,discussion,,discussion,10,11,21,11,11,22,10,0.239307,0.260599,43721.812525,15,0.001379
n372,enterprise,,enterprise,4,4,8,4,4,8,10,0.249611,0.271663,6364.013558,5,0.000447
n373,share,,share,7,6,13,8,8,16,10,0.246048,0.267973,19129.960811,16,0.000932
n374,shared,,shared,6,6,12,7,7,14,10,0.222839,0.240807,19787.869729,14,0.000837
n375,communitybuilding,,communitybuilding,1,1,2,1,1,2,10,0.221208,0.236933,0,11,0.000152
n376,take,,take,8,6,14,8,8,16,11,0.204394,0.218124,37156.340619,15,0.000911
n377,greater,,greater,2,2,4,2,2,4,12,0.16506,0.172081,10307.688766,15,0.000329
n378,relevance,,relevance,1,1,2,1,1,2,11,0.197038,0.208273,5096.749847,15,0.000199
n379,context,,context,7,8,15,8,8,16,10,0.245272,0.268041,42331.808208,15,0.00105
n380,learners’,,learners’,1,1,2,1,1,2,12,0.15992,0.166272,2570.644444,15,0.00017
n381,society,,society,1,1,2,1,1,2,11,0.190279,0.200992,2582.644444,15,0.000204
n382,compare,,compare,3,3,6,3,3,6,10,0.197538,0.209354,9722.905298,23,0.000358
n383,notes,,notes,1,1,2,1,1,2,11,0.197523,0.208402,252.176455,23,0.00016
n384,conclusions,,conclusions,8,7,15,8,7,15,10,0.219731,0.2362,20765.726789,12,0.000918
n385,multiple,,multiple,4,4,8,4,4,8,11,0.194413,0.206514,8906.103061,4,0.000523
n386,media,,media,4,5,9,7,7,14,10,0.232335,0.25349,20469.201408,21,0.000836
n387,online,,online,2,2,4,2,2,4,11,0.186628,0.196784,3526.692163,21,0.000259
n388,networks,,networks,1,1,2,1,1,2,12,0.163328,0.170023,2641.125188,23,0.000154
n389,“reflect”,,“reflect”,1,1,2,1,1,2,11,0.195122,0.20652,2653.125188,23,0.00019
n390,tells,,tells,1,1,2,1,1,2,11,0.195255,0.205869,184.015825,21,0.000168
n391,inquirer,,inquirer,1,1,2,1,1,2,10,0.199689,0.212695,287.049589,21,0.000164
n392,recognize,,recognize,3,3,6,3,3,6,11,0.192692,0.204106,4556.783497,21,0.000358
n393,say,,say,3,3,6,3,3,6,10,0.199255,0.211243,11980.462356,15,0.000492
n394,whether,,whether,2,2,4,2,2,4,12,0.177741,0.186552,3186.240189,15,0.000343
n395,transformed,,transformed,2,2,4,2,2,4,11,0.205424,0.219209,6315.331063,15,0.0003
n396,whole,,whole,2,2,4,2,2,4,11,0.193928,0.205082,5361.65483,7,0.000317
n397,later,,later,3,3,6,3,3,6,11,0.206497,0.220205,8173.222899,21,0.000405
n398,articulated,,articulated,1,1,2,1,1,2,11,0.194148,0.205353,368.208885,21,0.000174
n399,work,,work,13,12,25,13,13,26,10,0.24081,0.263594,65616.819163,20,0.001553
n400,sch¨on1987,,sch¨on1987,1,1,2,1,1,2,10,0.202972,0.215592,501.889102,20,0.00016
n401,expressing,,expressing,3,3,6,3,3,6,11,0.202812,0.216282,3213.495084,1,0.000431
n402,thereby,,thereby,1,1,2,1,1,2,11,0.180375,0.188753,199.860188,23,0.000156
n403,able,,able,4,4,8,4,4,8,10,0.219995,0.235555,6882.436604,21,0.000472
n404,move,,move,3,3,6,3,3,6,11,0.21887,0.233932,7401.790689,21,0.000346
n405,concepts,,concepts,15,22,37,23,23,46,10,0.257134,0.283933,98380.51906,18,0.002578
n406,mean,,mean,1,1,2,1,1,2,14,0.122239,0.125198,10214,21,0.000151
n407,recognizing,,recognizing,1,1,2,1,1,2,13,0.139217,0.143314,10226,21,0.000187
n408,indeterminacies,,indeterminacies,1,1,2,1,1,2,12,0.161672,0.167819,10238,21,0.000218
n409,leading,,leading,1,1,2,1,1,2,11,0.192764,0.203018,10250,21,0.000244
n410,continuing,,continuing,1,1,2,1,1,2,10,0.238662,0.258619,10262,21,0.000267
n411,taking,,taking,2,2,4,2,2,4,11,0.201207,0.214329,3997.780594,12,0.000268
n412,time,,time,12,13,25,13,13,26,10,0.251051,0.277871,57116.575818,23,0.00165
n413,back,,back,2,2,4,2,2,4,11,0.192014,0.202949,1217.902864,23,0.00027
n414,initial,,initial,4,4,8,4,5,9,10,0.235618,0.256002,9959.069366,4,0.000469
n415,research,,research,13,14,27,14,14,28,10,0.252284,0.277781,75614.530866,18,0.001645
n416,made,,made,7,7,14,8,8,16,11,0.206947,0.222176,34872.666318,15,0.000879
n417,inventory,,inventory,1,1,2,1,1,2,12,0.180236,0.188997,1973.860874,23,0.000173
n418,observations,,observations,13,14,27,18,18,36,10,0.255345,0.281057,61227.819255,12,0.00185
n419,decisions,,decisions,1,1,2,1,1,2,12,0.173701,0.181328,1216.734859,11,0.000155
n420,solution,,solution,6,4,10,6,6,12,11,0.210164,0.223962,19780.416463,11,0.000808
n421,light,,light,3,3,6,3,3,6,11,0.184536,0.194538,10285.640994,20,0.00045
n422,might,,might,4,4,8,4,4,8,10,0.220884,0.237728,20498.017998,12,0.000474
n423,again—thus,,again—thus,1,1,2,1,1,2,11,0.194752,0.205377,1308.068189,15,0.000154
n424,circle,,circle,2,2,4,2,2,4,10,0.241762,0.262661,11849.468089,15,0.000303
n425,break,,break,62,59,121,72,68,140,10,0.282353,0.324089,529146.250845,9,0.00858
n426,structural,,structural,6,3,9,6,6,12,11,0.203358,0.216302,12352.345468,12,0.000776
n427,pedagogy,,pedagogy,6,9,15,9,9,18,11,0.215581,0.232142,23698.030836,10,0.000934
n428,whereby,,whereby,3,3,6,3,3,6,11,0.200609,0.213058,8823.141154,10,0.000403
n429,pupils,,pupils,8,8,16,8,8,16,10,0.245671,0.268552,26973.046334,12,0.000928
n430,learned,,learned,8,7,15,8,7,15,10,0.237602,0.258312,20541.554222,7,0.00088
n431,designing,,designing,7,7,14,7,7,14,11,0.227056,0.245231,21254.059825,19,0.000797
n432,class,,class,6,5,11,6,6,12,10,0.217812,0.233498,20765.82634,15,0.000733
n433,activities,,activities,20,28,48,30,31,61,10,0.26156,0.291191,183800.559381,5,0.003295
n434,teacher,,teacher,18,16,34,19,18,37,10,0.265344,0.294799,110138.426945,15,0.002031
n435,created,,created,2,2,4,2,2,4,11,0.18275,0.191781,2359.835281,15,0.000257
n436,conditions,,conditions,4,4,8,4,4,8,10,0.252012,0.27571,11472.787812,5,0.000456
n437,left,,left,1,1,2,1,1,2,11,0.193257,0.20366,212.531548,16,0.00015
n438,unsupported,,unsupported,2,2,4,2,2,4,10,0.239508,0.259913,4025.776458,16,0.00028
n439,draw,,draw,3,3,6,3,3,6,10,0.193519,0.204692,13634.038709,0,0.000465
n440,manage,,manage,2,2,4,2,2,4,11,0.20389,0.21633,1720.845161,23,0.000273
n441,direct,,direct,2,2,4,2,2,4,11,0.200187,0.213479,1032.109544,23,0.000267
n442,impulses,,impulses,1,1,2,1,1,2,12,0.17062,0.177941,410.506622,1,0.000155
n443,toward,,toward,4,4,8,4,4,8,11,0.205654,0.218725,9610.293312,1,0.0005
n444,project,,project,7,7,14,7,7,14,11,0.215835,0.231631,29856.205624,9,0.001009
n445,goals,,goals,4,4,8,5,5,10,10,0.242241,0.264134,11940.519433,18,0.000579
n446,often,,often,13,13,26,13,13,26,10,0.226156,0.246883,62370.369913,6,0.001421
n447,guided,,guided,17,9,26,18,19,37,9,0.258558,0.283343,72094.051844,16,0.002106
n448,classroom,,classroom,11,10,21,12,12,24,10,0.251641,0.276025,69701.729671,14,0.00154
n449,times,,times,5,5,10,5,5,10,11,0.191128,0.202841,27749.921088,2,0.00067
n450,seeking,,seeking,1,1,2,1,1,2,11,0.179405,0.187673,624.284642,2,0.000173
n451,arouse,,arouse,2,2,4,2,2,4,10,0.218572,0.233811,5262.925311,5,0.000304
n452,specifying,,specifying,1,1,2,1,1,2,12,0.164636,0.171484,297.986016,14,0.000173
n453,individual,,individual,3,3,6,3,3,6,11,0.196993,0.208954,3859.42956,14,0.000389
n454,within,,within,18,17,35,20,20,40,10,0.261694,0.288355,100689.596463,23,0.002342
n455,group,,group,4,4,8,4,4,8,10,0.243228,0.264341,7617.599334,5,0.000478
n456,encouraging,,encouraging,2,2,4,2,2,4,10,0.229122,0.247158,10850.142741,2,0.000271
n457,functions,,functions,2,2,4,2,2,4,11,0.20989,0.223743,10251.30464,15,0.000289
n458,involved,,involved,3,3,6,3,3,6,10,0.223072,0.240021,4385.309267,16,0.000356
n459,directing,,directing,1,1,2,1,1,2,12,0.175494,0.184041,62.042135,2,0.00016
n460,modeling,,modeling,6,6,12,7,7,14,11,0.212777,0.22877,30216.223199,2,0.000851
n461,scaffolding,,scaffolding,5,5,10,5,5,10,10,0.248741,0.272688,33426.320202,5,0.000678
n462,primary,,primary,8,5,13,9,9,18,11,0.212777,0.229372,22591.905191,10,0.000992
n463,education,,education,12,25,37,27,27,54,10,0.263061,0.29365,82175.074662,18,0.002649
n464,ahead,,ahead,1,1,2,1,1,2,13,0.150713,0.156144,66.589501,13,0.000151
n465,signature,,signature,3,1,4,3,3,6,12,0.177397,0.186168,4622.866246,10,0.000363
n466,sharply,,sharply,1,1,2,1,1,2,12,0.171853,0.179381,74.328827,22,0.000158
n467,defined,,defined,3,3,6,3,3,6,11,0.207431,0.22091,4528.725425,22,0.000385
n468,instead,,instead,4,4,8,4,4,8,10,0.215129,0.229891,2969.464588,3,0.000449
n469,needs,,needs,4,4,8,4,4,8,11,0.205786,0.219256,9457.033158,3,0.00046
n470,set,,set,8,8,16,8,8,16,10,0.241762,0.263118,36780.007726,16,0.001031
n471,conceptions,,conceptions,3,3,6,3,3,6,10,0.239284,0.259651,6972.755235,5,0.000425
n472,openended,,openended,4,4,8,4,4,8,9,0.250024,0.272995,9977.864541,16,0.00044
n473,authors,,authors,4,4,8,4,4,8,10,0.214161,0.230578,8691.204997,14,0.000451
n474,argued,,argued,2,2,4,2,2,4,10,0.244875,0.265948,4389.810244,14,0.000241
n475,general,,general,7,7,14,7,7,14,10,0.243067,0.265066,20014.113877,18,0.000849
n476,productive,,productive,4,4,8,4,4,8,10,0.242768,0.26397,13443.228268,4,0.000502
n477,literacy,,literacy,4,4,8,4,4,8,11,0.215835,0.231443,12044.907645,20,0.000434
n478,unlikely,,unlikely,1,1,2,1,1,2,12,0.181587,0.19024,405.904473,20,0.000151
n479,empirical,,empirical,11,7,18,12,12,24,10,0.229347,0.249795,30407.634171,20,0.001347
n480,results,,results,13,14,27,15,15,30,10,0.228044,0.249611,77066.839413,2,0.001698
n481,alone,,alone,2,2,4,2,2,4,11,0.191871,0.202762,4134.165166,2,0.000303
n482,theoretical,,theoretical,8,6,14,8,8,16,10,0.222897,0.240167,38292.446619,16,0.001066
n483,analysis,,analysis,7,7,14,7,7,14,11,0.21044,0.225446,32010.691929,17,0.000976
n484,removed,,removed,1,1,2,1,1,2,11,0.200766,0.212223,546.418628,17,0.000177
n485,sense,,sense,4,5,9,5,5,10,10,0.240946,0.262489,12723.790179,21,0.000629
n486,grow,,grow,1,1,2,1,1,2,12,0.177975,0.186313,82.51627,3,0.000157
n487,action—an,,action—an,1,1,2,1,1,2,11,0.17928,0.187648,98.491524,3,0.000165
n488,experimental,,experimental,2,2,4,2,2,4,10,0.218349,0.233852,3215.16786,3,0.000284
n489,knowing,,knowing,3,3,6,3,3,6,11,0.184722,0.194387,10297.152884,3,0.000392
n490,attends,,attends,1,1,2,1,1,2,10,0.217535,0.232777,3018.484355,3,0.00017
n491,teachers,,teachers,27,30,57,32,32,64,10,0.249272,0.277942,200354.51617,7,0.003701
n492,actually,,actually,2,2,4,2,2,4,11,0.17136,0.178697,7789.435504,7,0.000291
n493,seeks,,seeks,1,1,2,1,1,2,10,0.204442,0.216122,4434.309233,7,0.000183
n494,terms,,terms,7,9,16,9,9,18,10,0.219995,0.237293,38763.643214,14,0.00103
n495,deeper,,deeper,1,1,2,1,1,2,11,0.193141,0.203476,115.104903,5,0.000156
n496,wide,,wide,2,2,4,2,2,4,11,0.179719,0.188616,5479.132134,5,0.000305
n497,range,,range,2,2,4,2,2,4,10,0.218889,0.234867,5981.848209,5,0.000281
n498,shows,,shows,2,2,4,2,2,4,11,0.174149,0.182579,4124.432893,18,0.000242
n499,value,,value,3,3,6,3,3,6,11,0.200672,0.213448,11435.54212,4,0.000441
n500,learnercentered,,learnercentered,1,1,2,1,1,2,12,0.177409,0.186181,352.385407,4,0.000184
n501,oriented,,oriented,2,2,4,2,2,4,11,0.197569,0.208972,3283.539387,11,0.00029
n502,developing,,developing,10,10,20,11,11,22,10,0.2378,0.259005,41948.191922,0,0.001287
n503,powerful,,powerful,2,2,4,2,2,4,11,0.184073,0.193564,2780.666929,5,0.00025
n504,environments,,environments,4,4,8,5,5,10,10,0.22481,0.241959,6390.210142,23,0.000541
n505,use,,use,18,15,33,19,19,38,9,0.265454,0.292468,96854.289059,16,0.002111
n506,ends,,ends,1,1,2,1,1,2,11,0.199085,0.211046,207.789969,21,0.00016
n507,make,,make,12,12,24,16,16,32,10,0.248476,0.273266,67159.685417,21,0.001744
n508,lives,,lives,2,2,4,3,3,6,11,0.215708,0.230718,324.735803,5,0.000335
n509,reported,,reported,1,1,2,1,1,2,13,0.140689,0.145304,257.919564,1,0.000151
n510,detail,,detail,2,2,4,2,2,4,12,0.163671,0.170842,10240.877114,1,0.00028
n511,actual,,actual,2,2,4,2,2,4,11,0.194619,0.205992,15162.903916,10,0.000363
n512,classrooms,,classrooms,3,4,7,4,4,8,11,0.205522,0.218423,9422.330698,10,0.000481
n513,employ,,employ,2,2,4,2,2,4,10,0.239642,0.260338,2969.552105,10,0.000258
n514,soundness,,soundness,1,1,2,1,1,2,12,0.162542,0.169054,4296.689157,16,0.000172
n515,viability,,viability,1,1,2,1,1,2,10,0.23864,0.258609,3746.370741,16,0.000211
n516,enriched,,enriched,3,3,6,3,3,6,10,0.234885,0.254821,3517.272584,5,0.000345
n517,enhance,,enhance,4,4,8,4,4,8,10,0.230666,0.248512,13511.756703,21,0.00048
n518,enable,,enable,4,4,8,4,4,8,10,0.242653,0.264049,9577.330769,16,0.00046
n519,offering,,offering,1,1,2,1,1,2,11,0.217701,0.231836,325.169502,11,0.000143
n520,entry,,entry,3,2,5,3,3,6,10,0.23864,0.258584,6719.32798,21,0.000345
n521,points,,points,3,4,7,4,4,8,11,0.209325,0.223875,18351.757242,21,0.000513
n522,pictures,,pictures,1,1,2,1,1,2,12,0.168371,0.175683,86.48638,12,0.000173
n523,facilitating,,facilitating,1,1,2,1,1,2,11,0.19317,0.203733,401.063734,12,0.000166
n524,connection,,connection,1,1,2,1,1,2,12,0.164257,0.171482,59.264422,21,0.000169
n525,sustain,,sustain,2,2,4,2,2,4,10,0.240607,0.261094,9248.544985,21,0.000244
n526,expansion—as,,expansion—as,1,1,2,1,1,2,11,0.217701,0.231836,1004.967438,11,0.00015
n527,facilitated,,facilitated,1,1,2,1,1,2,12,0.171888,0.179761,245.668065,16,0.000165
n528,reviewing,,reviewing,2,2,4,2,2,4,11,0.207465,0.221597,4861.059666,16,0.000308
n529,outputs,,outputs,1,1,2,1,1,2,15,0.109823,0.112268,5121,0,0.000171
n530,photo,,photo,1,1,2,1,1,2,14,0.123319,0.126541,5133,0,0.000204
n531,story,,story,1,1,2,1,1,2,13,0.140597,0.145168,5145,0,0.000232
n532,web,,web,3,3,6,3,3,6,12,0.163504,0.170729,15763.649162,0,0.000504
n533,site,,site,1,0,1,1,0,1,0,0,0,0,0,0.000202
n534,elementary,,elementary,3,4,7,3,4,7,10,0.229368,0.24796,6329.269614,18,0.00033
n535,schools,,schools,1,1,2,1,1,2,13,0.137209,0.141198,2559.6,5,0.000129
n536,universityschool,,universityschool,1,1,2,1,1,2,12,0.15897,0.164942,2571.6,5,0.000169
n537,partnerships,,partnerships,2,2,4,2,2,4,11,0.188935,0.198936,12171.40478,5,0.000327
n538,sought,,sought,1,1,2,1,1,2,11,0.184668,0.193471,507.224128,5,0.000198
n539,begin,,begin,4,4,8,4,4,8,10,0.226375,0.242982,5753.972067,21,0.000509
n540,understanding,,understanding,25,26,51,32,32,64,9,0.26972,0.300627,177922.778996,18,0.003415
n541,scientific,,scientific,76,40,116,90,91,181,9,0.285207,0.323263,563994.866541,16,0.009819
n542,formally,,formally,1,1,2,1,1,2,11,0.182205,0.191071,1259.669201,16,0.000153
n543,introducing,,introducing,3,3,6,3,3,6,10,0.222762,0.239357,6414.981421,16,0.000424
n544,observation,,observation,8,8,16,9,9,18,10,0.21253,0.228025,31749.665433,16,0.000921
n545,inference,,inference,2,2,4,2,2,4,10,0.220732,0.237163,1459.60179,16,0.000238
n546,evidence,,evidence,23,25,48,31,31,62,10,0.257676,0.286803,137543.665071,0,0.003457
n547,qualitative,,qualitative,2,2,4,2,2,4,11,0.205112,0.21798,4077.728318,17,0.000282
n548,quantitative,,quantitative,1,1,2,1,1,2,11,0.205473,0.219416,525.613839,17,0.000179
n549,data,,data,30,32,62,37,35,72,10,0.258506,0.289342,202494.233068,0,0.004066
n550,develop,,develop,14,14,28,15,15,30,9,0.26803,0.295531,74660.160743,21,0.001539
n551,confirm,,confirm,5,4,9,5,5,10,10,0.223869,0.241049,12459.255404,2,0.000536
n552,derived,,derived,2,2,4,2,2,4,11,0.189339,0.200055,2040.612694,9,0.000251
n553,using,,using,17,15,32,19,19,38,10,0.243482,0.267488,113681.659558,0,0.002096
n554,senses,,senses,1,1,2,1,1,2,10,0.221992,0.238271,886.254889,16,0.000161
n555,inferences,,inferences,2,2,4,2,2,4,11,0.183141,0.192759,2158.973821,11,0.00025
n556,logical,,logical,3,3,6,4,4,8,10,0.210457,0.225023,3143.197492,16,0.000435
n557,interpretations,,interpretations,2,2,4,3,3,6,11,0.206763,0.220895,688.051084,12,0.000326
n558,based,,based,15,15,30,16,16,32,10,0.240788,0.263429,89016.826939,12,0.00182
n559,science,,science,97,80,177,126,125,251,9,0.310971,0.360181,1090071.173382,18,0.013595
n560,shown,,shown,5,5,10,5,5,10,11,0.22096,0.237546,17709.522627,21,0.000717
n561,young,,young,28,6,34,28,28,56,10,0.23616,0.25756,61398.93037,21,0.003101
n562,children,,children,60,72,132,86,86,172,9,0.289711,0.332019,592494.505448,21,0.009418
n563,attain,,attain,1,1,2,1,1,2,12,0.158636,0.164543,2171.617398,20,0.000145
n564,informed,,informed,2,2,4,2,2,4,11,0.188477,0.198322,5209.655446,20,0.000279
n565,formal,,formal,1,1,2,1,1,2,11,0.201301,0.212718,1094.48687,20,0.000177
n566,specific,,specific,10,9,19,10,10,20,10,0.251814,0.276315,51709.775841,18,0.001089
n567,provided,,provided,3,3,6,3,3,6,10,0.225679,0.243775,5229.853758,21,0.00035
n568,strategies,,strategies,4,4,8,4,4,8,10,0.234606,0.254067,12217.945801,5,0.000467
n569,attainment,,attainment,1,1,2,1,1,2,14,0.132789,0.136737,7662,3,0.000161
n570,akersonvolrich2006,,akersonvolrich2006,1,1,2,1,1,2,13,0.153058,0.158855,7674,3,0.000196
n571,khishfeabdelkhalick2002,,khishfeabdelkhalick2002,1,1,2,1,1,2,12,0.180629,0.190015,7686,3,0.000225
n572,metz2004,,metz2004,1,1,2,1,1,2,11,0.220316,0.237792,7698,3,0.00025
n573,‘practices’,,‘practices’,1,1,2,1,1,2,11,0.201443,0.213688,23.540873,21,0.000132
n574,throughout,,throughout,3,3,6,3,3,6,12,0.183442,0.193166,8468.607993,1,0.000396
n575,documents,,documents,1,1,2,1,1,2,12,0.175806,0.183899,460.864155,1,0.000171
n576,refer,,refer,3,3,6,3,3,6,11,0.213218,0.228007,7457.560747,1,0.000441
n577,scientists,,scientists,6,7,13,7,7,14,10,0.235532,0.255948,28362.900824,7,0.000781
n578,done,,done,4,4,8,4,4,8,11,0.214985,0.229657,16626.026699,7,0.000492
n579,repeatedly,,repeatedly,2,2,4,2,2,4,11,0.211916,0.225784,5774.686775,7,0.000328
n580,increasing,,increasing,2,2,4,2,2,4,11,0.200531,0.212899,1103.36319,7,0.000301
n581,levels,,levels,6,6,12,7,7,14,10,0.220108,0.237697,12338.390947,18,0.000774
n582,proficiency,,proficiency,2,4,6,4,4,8,10,0.23991,0.260815,9278.99523,18,0.000467
n583,bybee2011,,bybee2011,1,1,2,1,1,2,13,0.148921,0.153868,2558.189394,7,0.000158
n584,michaelsetal2008,,michaelsetal2008,1,1,2,1,1,2,12,0.17492,0.182693,2570.189394,7,0.000193
n585,engaging,,engaging,11,9,20,11,11,22,10,0.265701,0.294376,50718.074402,0,0.001333
n586,“form,,“form,1,1,2,1,1,2,10,0.212477,0.22638,447.477635,21,0.000152
n587,crosscutting,,crosscutting,2,1,3,2,2,4,11,0.204589,0.217008,2892.029314,18,0.000256
n588,disciplinary,,disciplinary,1,1,2,1,1,2,11,0.217075,0.231821,310.687201,18,0.000154
n589,engineering,,engineering,3,3,6,3,3,6,10,0.216544,0.232307,4246.817162,16,0.000346
n590,moreover,,moreover,3,3,6,3,3,6,12,0.19527,0.207664,5330.160091,9,0.000376
n591,students’,,students’,15,13,28,15,15,30,10,0.244037,0.26757,83011.363762,11,0.001839
n592,embeds,,embeds,1,1,2,1,1,2,12,0.173654,0.181379,174.823732,3,0.000153
n593,deeply,,deeply,2,2,4,2,2,4,11,0.210061,0.223788,8510.866283,3,0.000282
n594,worldview”,,worldview”,1,1,2,1,1,2,1,1,1,2557,3,0.000179
n595,nrc2012p42,,nrc2012p42,1,0,1,1,0,1,0,0,0,0,3,0.000211
n596,good,,good,1,2,3,1,2,3,10,0.239575,0.259537,4064.528211,12,0.000198
n597,framed,,framed,5,5,10,5,5,10,10,0.237448,0.256474,19334.690914,1,0.000567
n598,anderson2002,,anderson2002,3,3,6,3,3,6,11,0.180489,0.189546,13978.37258,16,0.00037
n599,framework,,framework,2,2,4,2,2,4,12,0.167014,0.174363,10570.133169,17,0.000296
n600,instructional,,instructional,10,7,17,17,17,34,11,0.235467,0.255976,27705.787271,5,0.001827
n601,allow,,allow,4,3,7,4,4,8,10,0.223635,0.240206,8600.940925,21,0.0005
n602,construct,,construct,8,6,14,8,8,16,10,0.241671,0.262719,36212.891689,11,0.000892
n603,und,,und,1,1,2,1,1,2,12,0.173784,0.182097,350.717096,19,0.000156
n604,evaluation,,evaluation,4,5,9,6,5,11,11,0.210268,0.225635,11461.763979,19,0.000704
n605,furtaketal2012,,furtaketal2012,4,4,8,4,4,8,11,0.190293,0.201403,10148.114559,18,0.000439
n606,suggested,,suggested,4,4,8,4,4,8,10,0.218442,0.235199,20782.034858,17,0.000619
n607,defining,,defining,3,3,6,3,3,6,10,0.244711,0.266062,12485.688878,17,0.000389
n608,two,,two,4,4,8,4,4,8,10,0.223499,0.239948,8034.472404,19,0.000528
n609,cognitive,,cognitive,16,12,28,17,17,34,10,0.249854,0.274594,92348.726622,19,0.001923
n610,guidance,,guidance,9,12,21,13,13,26,10,0.265783,0.295551,62217.441057,21,0.001414
n611,regarding,,regarding,2,2,4,2,2,4,11,0.213555,0.228476,1740.33492,21,0.000261
n612,minneretal2009,,minneretal2009,1,1,2,1,1,2,12,0.151674,0.156856,5109,21,0.00015
n613,concluded,,concluded,1,1,2,1,1,2,11,0.178731,0.18703,5121,21,0.000187
n614,“having,,“having,1,1,2,1,1,2,10,0.217535,0.232777,5133,21,0.000217
n615,actively,,actively,3,4,7,4,4,8,10,0.21477,0.229523,9517.013519,21,0.000503
n616,participate,,participate,2,2,4,2,2,4,10,0.225639,0.242271,3978.706959,16,0.000265
n617,increases,,increases,1,1,2,1,1,2,10,0.237251,0.256774,302.623962,18,0.000148
n618,conceptual,,conceptual,18,11,29,19,19,38,10,0.241104,0.263604,92920.875564,1,0.002262
n619,learning”,,learning”,1,1,2,1,1,2,15,0.109519,0.111914,5119.659091,1,0.00016
n620,p20,,p20,1,1,2,1,1,2,14,0.122959,0.126112,5131.659091,1,0.000195
n621,consistently,,consistently,1,1,2,1,1,2,13,0.140159,0.144606,5143.659091,1,0.000225
n622,duschl2008,,duschl2008,2,2,4,2,2,4,12,0.162955,0.169854,17913.635279,1,0.000349
n623,identified,,identified,1,1,2,1,1,2,11,0.194339,0.205414,10194.023582,1,0.000207
n624,epistemic,,epistemic,8,8,16,8,8,16,10,0.229778,0.249298,29453.873919,0,0.00084
n625,domain,,domain,8,8,16,8,8,16,10,0.250463,0.274046,28717.409826,18,0.000834
n626,principles,,principles,3,4,7,4,4,8,11,0.220562,0.236809,3995.088884,5,0.000449
n627,consists,,consists,3,3,6,5,5,10,10,0.220033,0.236589,5915.515927,11,0.000506
n628,generated,,generated,4,4,8,4,4,8,10,0.214859,0.22992,13588.665343,23,0.000443
n629,comprises,,comprises,2,2,4,2,2,4,11,0.195181,0.206144,4271.247866,18,0.000241
n630,collaborative,,collaborative,4,3,7,4,4,8,10,0.241308,0.2622,8396.840793,16,0.000492
n631,communicative,,communicative,1,1,2,2,2,4,11,0.206747,0.220192,103.911409,16,0.000268
n632,processes,,processes,19,24,43,27,27,54,10,0.260552,0.289844,144365.880332,16,0.002876
n633,realize,,realize,1,1,2,1,1,2,11,0.195122,0.205794,280.349973,11,0.000152
n634,curricula,,curricula,1,1,2,1,1,2,12,0.157276,0.162965,2555,3,0.000152
n635,instance,,instance,1,1,2,1,1,2,11,0.18656,0.19596,2567,3,0.000188
n636,include,,include,8,8,16,8,8,16,10,0.229245,0.247555,28151.996181,3,0.00094
n637,cognitively,,cognitively,1,1,2,1,1,2,11,0.189464,0.199169,203.79965,12,0.000159
n638,tasks,,tasks,9,8,17,9,9,18,10,0.217314,0.233524,47908.087759,5,0.001196
n639,scientifically,,scientifically,1,1,2,1,1,2,11,0.178024,0.186582,2604.072292,0,0.000154
n640,orientated,,orientated,1,1,2,1,1,2,10,0.216508,0.232195,2616.072292,0,0.00019
n641,student,,student,10,7,17,10,10,20,10,0.245671,0.268066,24817.465316,5,0.001091
n642,argumentation,,argumentation,2,3,5,3,3,6,10,0.244968,0.267818,5620.222385,18,0.000375
n643,ibse,,ibse,1,2,3,1,2,3,12,0.165924,0.173128,3317.138567,22,0.000168
n644,commonly,,commonly,3,3,6,3,3,6,11,0.180578,0.189442,6897.76819,22,0.000348
n645,classified,,classified,1,1,2,1,1,2,12,0.164563,0.172271,136.827665,22,0.000158
n646,according,,according,7,8,15,8,8,16,11,0.196887,0.210822,31858.523796,9,0.000995
n647,degrees,,degrees,1,1,2,1,1,2,11,0.179305,0.187785,462.534215,9,0.000165
n648,freedom,,freedom,2,2,4,2,2,4,10,0.218404,0.234114,5280.16695,9,0.000296
n649,operate,,operate,1,1,2,1,1,2,12,0.174397,0.182371,962.667975,21,0.000152
n650,degree,,degree,3,2,5,3,3,6,11,0.211167,0.225458,6327.728164,21,0.000392
n651,belletal2005,,belletal2005,1,1,2,1,1,2,14,0.128916,0.13238,6766.502296,7,0.00015
n652,accompanied,,accompanied,1,1,2,1,1,2,13,0.147952,0.15293,6778.502296,7,0.000187
n653,debate,,debate,1,1,2,1,1,2,12,0.173584,0.181426,6790.502296,7,0.000217
n654,effectiveness,,effectiveness,2,2,4,2,2,4,11,0.209958,0.224035,13233.6792,7,0.000415
n655,open,,open,8,7,15,8,8,16,10,0.244991,0.26722,40694.511998,16,0.001114
n656,minimally,,minimally,1,1,2,1,1,2,10,0.205522,0.217389,132.905962,16,0.000177
n657,versus,,versus,1,1,2,1,1,2,10,0.205456,0.217259,0,16,0.000153
n658,hmelosilveretal2007,,hmelosilveretal2007,3,3,6,3,3,6,12,0.175087,0.183908,14743.301365,19,0.000405
n659,kirschneretal2006,,kirschneretal2006,2,2,4,2,2,4,12,0.158793,0.165307,2924.733561,19,0.000261
n660,typically,,typically,4,3,7,4,4,8,12,0.177299,0.186296,6497.95305,23,0.00047
n661,role,,role,8,8,16,8,8,16,10,0.243921,0.266589,30506.487968,22,0.000943
n662,ie,,ie,4,5,9,5,5,10,10,0.210941,0.225472,13192.733736,16,0.000539
n663,ranging,,ranging,1,1,2,1,1,2,11,0.188215,0.197904,3204.441115,5,0.000151
n664,studentdirected,,studentdirected,2,2,4,2,2,4,10,0.231769,0.250398,14892.621766,5,0.000326
n665,teachersupported,,teachersupported,1,1,2,1,1,2,10,0.238617,0.258596,1181.696009,5,0.000197
n666,however,,however,10,11,21,11,11,22,10,0.234799,0.254925,66048.466377,16,0.001353
n667,curriculum,,curriculum,9,10,19,11,11,22,10,0.241399,0.26393,34092.140711,19,0.001267
n668,peers,,peers,3,3,6,3,3,6,10,0.212266,0.226962,5293.166956,2,0.000363
n669,high,,high,3,2,5,3,3,6,11,0.184576,0.194629,3756.412738,18,0.000349
n670,particularly,,particularly,2,2,4,2,2,4,11,0.196001,0.207668,5843.439427,15,0.000296
n671,fostering,,fostering,2,2,4,2,2,4,10,0.218628,0.23394,1755.205769,18,0.00026
n672,subject,,subject,2,1,3,2,2,4,12,0.169684,0.177107,7602.657463,20,0.000301
n673,matter,,matter,2,3,5,4,4,8,11,0.204312,0.217475,10492.404171,20,0.000516
n674,complex,,complex,6,5,11,6,6,12,10,0.243551,0.265249,17772.329542,12,0.000739
n675,limited,,limited,5,5,10,5,5,10,11,0.208543,0.223493,12686.518809,18,0.000614
n676,hardyetal2006,,hardyetal2006,2,2,4,2,2,4,12,0.169036,0.176773,2849.814123,18,0.000257
n677,large,,large,1,1,2,1,1,2,11,0.169763,0.176979,1091.201382,6,0.000201
n678,body,,body,2,2,4,2,2,4,10,0.204377,0.217143,6174.407327,6,0.000361
n679,far,,far,1,1,2,1,1,2,11,0.190674,0.201021,474.653998,7,0.000146
n680,proposed,,proposed,1,1,2,1,1,2,12,0.166472,0.173948,2555,7,0.000154
n681,treagustduit2008,,treagustduit2008,1,1,2,1,1,2,11,0.199627,0.212778,2567,7,0.00019
n682,challenged,,challenged,1,1,2,1,1,2,12,0.181024,0.18911,1022.393126,6,0.000152
n683,reach,,reach,2,2,4,2,2,4,11,0.22096,0.235811,5355.095618,6,0.00031
n684,curricular,,curricular,3,2,5,3,3,6,10,0.232377,0.251092,5035.438234,5,0.000417
n685,development,,development,9,11,20,12,12,24,9,0.265564,0.293451,73981.855779,1,0.001306
n686,considered,,considered,3,4,7,4,4,8,11,0.219995,0.236195,12071.58208,16,0.000433
n687,slow,,slow,1,1,2,1,1,2,11,0.181202,0.189762,2564.508333,16,0.000151
n688,gradual,,gradual,1,1,2,1,1,2,10,0.221227,0.236953,2576.508333,16,0.000187
n689,rather,,rather,4,4,8,4,4,8,11,0.203277,0.216235,19410.967455,21,0.000497
n690,dramatic,,dramatic,2,2,4,2,2,4,11,0.17903,0.187655,14845.563364,21,0.000275
n691,gestalttype,,gestalttype,1,1,2,1,1,2,13,0.134422,0.138216,7662,21,0.000176
n692,shift,,shift,1,1,2,1,1,2,12,0.155222,0.160816,7674,21,0.000208
n693,paradigms,,paradigms,1,1,2,1,1,2,11,0.183638,0.192766,7686,21,0.000236
n694,caravitahallden1994,,caravitahallden1994,1,1,2,1,1,2,10,0.22479,0.242017,7698,21,0.000259
n695,spontaneously,,spontaneously,1,1,2,1,1,2,11,0.194693,0.205254,0,11,0.000152
n696,explanations,,explanations,17,20,37,20,20,40,9,0.261427,0.289093,124684.721334,11,0.002329
n697,phenomena,,phenomena,8,8,16,8,8,16,10,0.242585,0.264665,38472.256221,23,0.000865
n698,daily,,daily,2,2,4,2,2,4,10,0.214518,0.227934,2689.227956,21,0.000242
n699,life,,life,6,5,11,6,6,12,10,0.232167,0.251044,13396.795549,5,0.000733
n700,carey2000,,carey2000,1,1,2,1,1,2,10,0.221973,0.238251,272.527071,5,0.000153
n701,view,,view,2,2,4,2,2,4,11,0.20203,0.21449,2776.462846,18,0.000244
n702,preinstructional,,preinstructional,1,1,2,1,1,2,11,0.193155,0.203489,237.093196,5,0.000163
n703,partially,,partially,1,1,2,1,1,2,14,0.128696,0.132057,5117.591667,6,0.000152
n704,entirely,,entirely,1,1,2,1,1,2,13,0.147654,0.152461,5129.591667,6,0.000188
n705,inadequate,,inadequate,1,1,2,1,1,2,12,0.173163,0.180691,5141.591667,6,0.000219
n706,furthermore,,furthermore,2,2,4,2,2,4,11,0.209325,0.222721,8255.423191,6,0.000354
n707,places,,places,3,3,6,4,4,8,10,0.210251,0.223466,5472.091383,5,0.000434
n708,demands,,demands,1,1,2,1,1,2,11,0.196225,0.207638,643.598952,18,0.000158
n709,language,,language,10,8,18,11,11,22,10,0.251198,0.276034,47547.000374,18,0.001354
n710,analyzing,,analyzing,5,4,9,5,5,10,11,0.20775,0.222776,12625.985253,0,0.000612
n711,summarizing,,summarizing,1,1,2,1,1,2,11,0.192533,0.202819,148.99985,18,0.000163
n712,presenting,,presenting,2,2,4,2,2,4,10,0.238352,0.258282,3256.160098,18,0.000299
n713,oral,,oral,2,1,3,2,2,4,12,0.171029,0.178673,752.668613,18,0.000341
n714,written,,written,2,3,5,3,3,6,11,0.206248,0.219917,5663.812942,18,0.00044
n715,formats,,formats,3,5,8,5,5,10,11,0.193519,0.206123,9675.747433,23,0.000649
n716,leefradd1998,,leefradd1998,1,1,2,1,1,2,12,0.170983,0.178676,379.167414,8,0.000169
n717,sufficient,,sufficient,2,2,4,2,2,4,11,0.206166,0.219815,4184.610592,8,0.000328
n718,needed,,needed,1,1,2,1,1,2,10,0.212495,0.2264,143.952285,18,0.000158
n719,explaining,,explaining,5,5,10,5,5,10,10,0.227882,0.246152,19051.231843,16,0.000572
n720,participating,,participating,2,2,4,2,2,4,11,0.213893,0.227559,2094.291399,11,0.000264
n721,akersonetal2000,,akersonetal2000,1,1,2,1,1,2,15,0.10442,0.10656,9302.729535,18,0.00015
n722,osborneetal2004,,osborneetal2004,1,1,2,1,1,2,14,0.116552,0.119283,9314.729535,18,0.000186
n723,van,,van,1,1,2,1,1,2,13,0.131875,0.135586,9326.729535,18,0.000217
n724,boxteletal2000,,boxteletal2000,1,1,2,1,1,2,12,0.151836,0.157298,9338.729535,18,0.000243
n725,accordingly,,accordingly,2,2,4,2,2,4,11,0.178917,0.187902,12691.505756,18,0.000404
n726,skills,,skills,26,38,64,37,38,75,10,0.273599,0.307387,224988.163377,16,0.003803
n727,connected,,connected,3,3,6,3,3,6,11,0.206913,0.220748,5928.050599,19,0.000403
n728,tractable,,tractable,1,1,2,1,1,2,12,0.151549,0.156831,2562.252724,5,0.000146
n729,dificult,,dificult,1,1,2,1,1,2,11,0.178569,0.187121,2574.252724,5,0.000183
n730,manageable,,manageable,1,1,2,1,1,2,13,0.149042,0.154448,173.847187,19,0.000172
n731,additional,,additional,1,1,2,1,1,2,11,0.210027,0.223851,5004.86435,19,0.000174
n732,particular,,particular,7,8,15,7,8,15,10,0.228734,0.246595,29617.230386,5,0.00086
n733,poor,,poor,1,1,2,1,1,2,11,0.200813,0.212901,396.044892,18,0.000152
n734,hence,,hence,2,2,4,2,2,4,12,0.177152,0.185892,3272.930397,16,0.000248
n735,especially,,especially,3,3,6,3,3,6,11,0.213893,0.229119,7788.55587,16,0.000378
n736,beneficial,,beneficial,1,1,2,1,1,2,10,0.217517,0.232764,930.159508,16,0.000166
n737,risk,,risk,1,1,2,1,1,2,12,0.169148,0.176462,2342.621767,6,0.000152
n738,achieving,,achieving,2,2,4,2,2,4,11,0.203519,0.216413,5621.042885,6,0.000317
n739,lamainalapates,,lamainalapates,1,2,3,1,2,3,11,0.171738,0.17936,10250,9,0.000242
n740,programme,,programme,3,3,6,3,3,6,12,0.189927,0.200841,10692.141684,9,0.000457
n741,advocates,,advocates,2,2,4,2,2,4,11,0.213431,0.227854,7084.898999,9,0.000323
n742,incites,,incites,1,1,2,1,1,2,10,0.224711,0.241983,1417.512902,10,0.000158
n743,explore,,explore,7,8,15,10,10,20,11,0.232841,0.252802,28835.460106,21,0.001035
n744,around,,around,2,6,8,7,7,14,10,0.218237,0.23425,9617.802476,12,0.000681
n745,experimentation,,experimentation,1,1,2,1,1,2,11,0.181715,0.190527,2574.852382,16,0.000146
n746,acquire,,acquire,1,1,2,1,1,2,10,0.221992,0.238271,2586.852382,16,0.000183
n747,content,,content,10,10,20,14,13,27,10,0.243274,0.266135,43494.308758,16,0.001524
n748,reason,,reason,1,1,2,1,1,2,11,0.17349,0.180604,2555,11,0.000152
n749,master,,master,1,1,2,1,1,2,10,0.209838,0.222387,2567,11,0.000188
n750,french,,french,1,1,2,1,1,2,13,0.159662,0.166045,3326.313273,9,0.000166
n751,shares,,shares,2,2,4,2,2,4,11,0.197721,0.209219,2938.106291,9,0.000275
n752,broad,,broad,2,2,4,2,2,4,11,0.197371,0.208682,3049.24604,9,0.000306
n753,main,,main,2,2,4,2,2,4,12,0.162861,0.169909,4443.207852,19,0.000262
n754,goal,,goal,4,4,8,5,5,10,11,0.184629,0.194953,9754.426683,14,0.000612
n755,contribute,,contribute,2,2,4,2,2,4,10,0.212056,0.225519,7468.438197,13,0.000274
n756,children’s,,children’s,29,28,57,35,35,70,10,0.276784,0.309594,199378.803471,5,0.004066
n757,creativity,,creativity,1,1,2,1,1,2,11,0.182958,0.191887,233.62807,5,0.000157
n758,critical,,critical,9,6,15,11,11,22,10,0.22383,0.240857,23111.673743,16,0.001182
n759,thinking,,thinking,17,23,40,26,26,52,10,0.25639,0.284388,103500.960793,16,0.002676
n760,reasoning,,reasoning,11,12,23,14,14,28,10,0.238817,0.261834,73040.112824,16,0.00179
n761,mastery,,mastery,1,1,2,1,1,2,11,0.200798,0.212868,562.93626,18,0.000144
n762,school,,school,5,5,10,5,5,10,10,0.221227,0.238691,16278.010569,9,0.000589
n763,lamainalapates2000,,lamainalapates2000,1,1,2,1,1,2,14,0.113448,0.115948,10214,9,0.000147
n764,saltiel2006,,saltiel2006,1,1,2,1,1,2,13,0.12792,0.131253,10226,9,0.000184
n765,sarmantetal2011,,sarmantetal2011,1,1,2,1,1,2,12,0.146626,0.151412,10238,9,0.000215
n766,promotes,,promotes,1,1,2,1,1,2,11,0.196887,0.207895,5729.874678,9,0.000162
n767,teacher’s,,teacher’s,2,2,4,2,2,4,11,0.216289,0.231852,2197.472986,9,0.00025
n768,expected,,expected,5,6,11,6,6,12,11,0.20485,0.218712,19943.5162,21,0.000711
n769,carry,,carry,4,3,7,4,4,8,11,0.1869,0.197141,11305.568952,12,0.000489
n770,experiments,,experiments,1,2,3,2,2,4,11,0.208916,0.223523,2143.048053,12,0.000267
n771,raise,,raise,1,1,2,1,1,2,11,0.201507,0.213683,738.306322,21,0.000151
n772,suggest,,suggest,2,2,4,2,2,4,11,0.190972,0.201846,3530.668429,12,0.000259
n773,answers,,answers,2,2,4,3,3,6,10,0.218349,0.234606,3147.776445,12,0.000344
n774,vital,,vital,2,2,4,2,2,4,10,0.246118,0.268571,1827.00328,16,0.000244
n775,influential,,influential,1,1,2,1,1,2,12,0.190646,0.201011,526.850944,9,0.000159
n776,5e,,5e,16,4,20,16,16,32,10,0.225026,0.242383,39716.80993,5,0.001883
n777,model,,model,15,29,44,33,33,66,10,0.256569,0.285918,124460.597435,5,0.003299
n778,bybeeetal2006,,bybeeetal2006,4,5,9,5,5,10,11,0.200562,0.213468,14293.103829,5,0.000563
n779,developed,,developed,5,5,10,5,5,10,10,0.207097,0.22137,19613.196832,5,0.000567
n780,biological,,biological,4,3,7,4,4,8,10,0.2196,0.235894,8404.504171,19,0.000552
n781,sciences,,sciences,1,1,2,2,2,4,11,0.194531,0.205638,247.645912,19,0.000294
n782,gets,,gets,1,1,2,1,1,2,12,0.182711,0.19196,1469.853742,5,0.000144
n783,phases,,phases,7,7,14,7,7,14,11,0.223499,0.241125,32607.43953,5,0.000959
n784,sequence,,sequence,3,3,6,3,3,6,11,0.198839,0.211378,10721.876583,5,0.000478
n785,instruction,,instruction,9,13,22,14,14,28,10,0.23769,0.260237,41442.269319,5,0.001432
n786,atkinskarplus1962,,atkinskarplus1962,1,1,2,1,1,2,13,0.13149,0.135186,5109,5,0.000144
n787,originally,,originally,1,1,2,1,1,2,12,0.151335,0.156748,5121,5,0.000181
n788,constituted,,constituted,1,1,2,1,1,2,11,0.178234,0.187027,5133,5,0.000213
n789,explanation,,explanation,7,10,17,11,11,22,9,0.256569,0.281155,35197.892458,19,0.001201
n790,concept,,concept,10,11,21,11,11,22,10,0.226136,0.244354,60698.512033,16,0.00126
n791,formation,,formation,1,1,2,1,1,2,14,0.133917,0.137771,5130.25,5,0.000156
n792,extension,,extension,1,1,2,1,1,2,13,0.154568,0.160243,5142.25,5,0.000192
n793,expansion,,expansion,1,1,2,1,1,2,12,0.18275,0.192002,5154.25,5,0.000222
n794,3e,,3e,1,1,2,1,1,2,10,0.231706,0.250106,1680.248092,5,0.000175
n795,piaget’s,,piaget’s,2,2,4,2,2,4,11,0.20138,0.212904,8297.994868,5,0.000316
n796,mental,,mental,2,2,4,2,2,4,11,0.196195,0.207453,6161.786471,18,0.000317
n797,functioning,,functioning,2,2,4,2,2,4,11,0.209445,0.224205,2588.388695,18,0.000317
n798,marek2008,,marek2008,1,1,2,1,1,2,11,0.183717,0.192868,130.105082,5,0.000144
n799,established,,established,2,2,4,2,2,4,10,0.213608,0.228515,1324.179368,1,0.000269
n800,constructivist,,constructivist,3,3,6,3,3,6,10,0.240855,0.261475,6504.480784,5,0.000379
n801,approach,,approach,14,17,31,18,18,36,10,0.259289,0.287184,78195.393558,5,0.001988
n802,operates,,operates,2,2,4,2,2,4,12,0.169662,0.177286,6214.308531,23,0.000233
n803,assumption,,assumption,2,2,4,2,2,4,11,0.20339,0.216241,3151.340918,23,0.000249
n804,bring,,bring,3,3,6,3,3,6,10,0.228734,0.245767,6705.876433,6,0.000422
n805,testing,,testing,4,4,8,4,4,8,11,0.22552,0.241924,8908.958295,11,0.000501
n806,existing,,existing,4,4,8,4,4,8,10,0.23747,0.256827,5491.849574,11,0.000485
n807,know,,know,4,6,10,6,6,12,11,0.200031,0.212526,8914.804144,2,0.000579
n808,real,,real,4,3,7,4,4,8,11,0.223596,0.239996,7267.412835,12,0.00045
n809,familiar,,familiar,2,2,4,2,2,4,11,0.189534,0.199932,2093.604288,16,0.000242
n810,easily,,easily,2,2,4,2,2,4,12,0.161286,0.168083,7710.740765,16,0.000256
n811,assimilated,,assimilated,1,1,2,1,1,2,11,0.190265,0.200982,2423.984778,16,0.000168
n812,accommodation,,accommodation,1,1,2,1,1,2,12,0.163974,0.170731,3307.799177,20,0.000148
n813,fit,,fit,3,3,6,4,4,8,11,0.196075,0.207831,7916.17719,20,0.000573
n814,unfamiliar,,unfamiliar,3,3,6,3,3,6,10,0.223421,0.239541,19438.397367,2,0.000376
n815,colburn2003,,colburn2003,1,1,2,1,1,2,12,0.155279,0.160911,2635.314059,23,0.000158
n816,researchbased,,researchbased,1,1,2,1,1,2,11,0.183757,0.192933,2647.314059,23,0.000193
n817,incorporates,,incorporates,3,3,6,3,3,6,11,0.210526,0.223793,12251.746974,5,0.000334
n818,notion,,notion,4,4,8,4,4,8,10,0.251051,0.273442,12727.327039,5,0.000468
n819,place,,place,3,5,8,5,5,10,11,0.209547,0.22417,21550.312416,23,0.000661
n820,setting,,setting,5,5,10,5,5,10,10,0.207549,0.221687,19366.093347,5,0.00053
n821,cooperation,,cooperation,1,1,2,1,1,2,13,0.151495,0.156606,5109,5,0.000149
n822,collaboration,,collaboration,1,1,2,1,1,2,12,0.17847,0.186596,5121,5,0.000186
n823,coconstruction,,coconstruction,1,1,2,1,1,2,11,0.21713,0.231863,5133,5,0.000217
n824,essential,,essential,5,4,9,5,5,10,10,0.242333,0.26381,7440.367412,16,0.000519
n825,itemized,,itemized,1,1,2,1,1,2,12,0.172883,0.180723,1277.289791,11,0.000144
n826,manner,,manner,3,3,6,3,3,6,11,0.192894,0.204704,13109.706776,21,0.000443
n827,effective,,effective,5,5,10,5,5,10,10,0.228918,0.248511,15270.557554,21,0.000542
n828,cyclical,,cyclical,1,1,2,1,1,2,12,0.161733,0.168542,4519.880991,21,0.000154
n829,guest,,guest,1,1,2,1,1,2,15,0.116908,0.119838,5123.75873,4,0.000184
n830,editorial,,editorial,1,1,2,1,1,2,14,0.13233,0.136355,5135.75873,4,0.000216
n831,bybee2014,,bybee2014,1,1,2,1,1,2,13,0.15244,0.158447,5147.75873,4,0.000242
n832,reflects,,reflects,3,3,6,4,4,8,12,0.179756,0.189874,10150.833963,4,0.000561
n833,design,,design,10,9,19,10,10,20,10,0.229552,0.248489,38092.838613,5,0.001195
n834,responds,,responds,1,1,2,1,1,2,10,0.216508,0.232195,1933.824863,5,0.000144
n835,recommendations,,recommendations,1,1,2,1,1,2,15,0.110059,0.112382,7662.571429,22,0.000161
n836,enumerates,,enumerates,1,1,2,1,1,2,14,0.123622,0.126658,7674.571429,22,0.000196
n837,implications,,implications,1,1,2,1,1,2,13,0.140998,0.145248,7686.571429,22,0.000225
n838,usage,,usage,1,1,2,1,1,2,12,0.164058,0.17055,7698.571429,22,0.00025
n839,applications,,applications,2,2,4,2,2,4,11,0.196135,0.207336,13121.12002,22,0.000375
n840,era,,era,1,1,2,1,1,2,11,0.189632,0.199527,1194.028262,22,0.000219
n841,generation,,generation,2,1,3,3,3,6,10,0.237272,0.256806,760.735057,18,0.000394
n842,standards,,standards,4,6,10,6,6,12,11,0.203342,0.216611,25986.410875,18,0.000619
n843,ngss2013,,ngss2013,1,1,2,1,1,2,12,0.161733,0.168021,5494.539255,18,0.000147
n844,recommends,,recommends,2,2,4,2,2,4,11,0.19288,0.203495,12792.1,18,0.000319
n845,preferable,,preferable,1,1,2,1,1,2,13,0.135859,0.139752,2567.1,15,0.000194
n846,timeframe,,timeframe,1,1,2,1,1,2,12,0.157131,0.162946,2579.1,15,0.000224
n847,longer,,longer,2,2,4,2,2,4,11,0.186303,0.196031,6109.709813,15,0.000345
n848,period,,period,3,3,6,3,3,6,11,0.205243,0.21948,4717.319298,15,0.000399
n849,gives,,gives,3,3,6,3,3,6,10,0.233901,0.254422,17900.380318,15,0.000374
n850,unit,,unit,4,4,8,4,4,8,10,0.212039,0.226606,12674.028621,3,0.000471
n851,spanning,,spanning,1,1,2,1,1,2,15,0.119737,0.122794,2638.933442,7,0.000162
n852,2–3,,2–3,1,1,2,1,1,2,14,0.135967,0.14022,2650.933442,7,0.000197
n853,weeks,,weeks,2,2,4,2,2,4,13,0.157285,0.163791,9253.630974,7,0.000334
n854,lose,,lose,1,1,2,1,1,2,12,0.173596,0.181435,3863.176903,7,0.000201
n855,bybee,,bybee,1,1,2,1,1,2,11,0.201522,0.213703,1697.764002,9,0.000165
n856,omitting,,omitting,1,1,2,1,1,2,11,0.191171,0.202044,877.942008,18,0.000162
n857,phase,,phase,8,7,15,8,9,17,10,0.236247,0.257989,32270.548768,7,0.00113
n858,nrc1999,,nrc1999,1,1,2,1,1,2,13,0.142342,0.146944,2612.934524,5,0.000155
n859,rearranging,,rearranging,1,1,2,1,1,2,12,0.165913,0.173035,2624.934524,5,0.00019
n860,renner,,renner,1,1,2,1,1,2,13,0.139839,0.144062,2588.127273,0,0.000175
n861,abrahambernie1988,,abrahambernie1988,1,1,2,1,1,2,12,0.162521,0.168984,2600.127273,0,0.000208
n862,result,,result,4,4,8,4,4,8,11,0.193987,0.205261,17276.153137,0,0.000602
n863,losing,,losing,2,2,4,2,2,4,12,0.166818,0.174586,1255.136891,5,0.000331
n864,integrity,,integrity,1,1,2,1,1,2,10,0.231727,0.250119,3097.492145,5,0.000194
n865,seem,,seem,2,2,4,2,2,4,11,0.211532,0.226565,7589.353849,10,0.000291
n866,inflexible,,inflexible,1,1,2,1,1,2,11,0.202716,0.215139,171.2938,18,0.000144
n867,suitable,,suitable,2,2,4,2,2,4,11,0.212161,0.226158,644.654813,18,0.00028
n868,childhood,,childhood,1,13,14,17,17,34,10,0.253304,0.279362,6164.417079,18,0.001669
n869,repetition,,repetition,1,1,2,1,1,2,12,0.182737,0.191992,582.386246,5,0.000157
n870,chance,,chance,3,3,6,3,3,6,11,0.201128,0.213217,8009.999659,18,0.000409
n871,extended,,extended,2,2,4,2,2,4,10,0.239978,0.260685,4615.945962,16,0.000279
n872,allowed,,allowed,1,1,2,1,1,2,14,0.122268,0.125432,7662,0,0.000157
n873,flexibility,,flexibility,1,1,2,1,1,2,13,0.139255,0.143665,7674,0,0.000193
n874,add,,add,1,1,2,1,1,2,12,0.161723,0.168394,7686,0,0.000223
n875,prerequisite,,prerequisite,1,1,2,1,1,2,11,0.192836,0.204097,7698,0,0.000248
n876,deem,,deem,1,1,2,1,1,2,12,0.160973,0.167347,370.17175,8,0.000169
n877,necessary,,necessary,3,3,6,3,3,6,11,0.191771,0.202685,7605.365024,8,0.000441
n878,grades,,grades,2,2,4,2,2,4,11,0.200766,0.214324,3801.34165,10,0.000247
n879,yoononchwari2006,,yoononchwari2006,1,1,2,1,1,2,11,0.190222,0.200324,164.14784,10,0.000164
n880,preschool,,preschool,8,8,16,8,8,16,10,0.237976,0.258897,31874.085438,14,0.000849
n881,settings,,settings,4,4,8,4,4,8,10,0.202332,0.214747,7645.10424,3,0.000467
n882,fledgling,,fledgling,1,1,2,1,1,2,12,0.157189,0.163967,465.486114,8,0.000194
n883,milleretal2013,,milleretal2013,1,1,2,1,1,2,12,0.158685,0.164713,4907.465413,8,0.000169
n884,last,,last,2,2,4,2,2,4,11,0.188546,0.198611,7780.164991,8,0.000372
n885,century,,century,1,1,2,1,1,2,11,0.204491,0.21675,2152.033982,8,0.000217
n886,greatly,,greatly,1,1,2,1,1,2,13,0.143672,0.148024,2565.651526,18,0.000153
n887,influenced,,influenced,1,1,2,1,1,2,12,0.167701,0.174371,2577.651526,18,0.000189
n888,investigative,,investigative,5,4,9,5,5,10,10,0.230417,0.248504,6863.002761,12,0.000535
n889,competencies,,competencies,1,1,2,1,1,2,10,0.231706,0.250106,294.074214,12,0.00015
n890,designed,,designed,6,6,12,7,7,14,11,0.219863,0.236014,16659.081057,15,0.000816
n891,compatible,,compatible,1,1,2,1,1,2,11,0.216837,0.231336,766.592671,15,0.000158
n892,playbased,,playbased,1,1,2,1,1,2,11,0.192764,0.203356,207.232617,16,0.000158
n893,hatch2010,,hatch2010,1,1,2,1,1,2,11,0.22024,0.237743,0,1,0.000151
n894,integrating,,integrating,1,1,2,1,1,2,11,0.19431,0.205381,257.540915,1,0.000166
n895,play,,play,6,8,14,8,8,16,10,0.231351,0.251127,22544.765308,1,0.000904
n896,nsta2014,,nsta2014,1,1,2,1,1,2,13,0.146225,0.151075,4022.244774,18,0.000144
n897,position,,position,3,2,5,3,3,6,12,0.1712,0.178886,15466.070005,18,0.000451
n898,statement,,statement,1,2,3,2,2,4,11,0.205063,0.217804,9419.449161,18,0.000314
n899,declares,,declares,1,1,2,1,1,2,11,0.195583,0.206901,205.272006,1,0.000142
n900,educators,,educators,4,4,8,4,4,8,11,0.201823,0.214408,6516.320173,23,0.000496
n901,nurture,,nurture,1,1,2,1,1,2,11,0.216855,0.231355,684.425208,5,0.00016
n902,focus,,focus,8,8,16,9,9,18,10,0.257857,0.28243,53548.037499,5,0.001093
n903,connect,,connect,1,1,2,1,1,2,10,0.237251,0.256774,0,18,0.000153
n904,ngssleadstates2013,,ngssleadstates2013,1,1,2,1,1,2,11,0.19958,0.210992,149.708445,8,0.000147
n905,academic,,academic,1,1,2,1,1,2,12,0.183481,0.19343,70.461186,8,0.000157
n906,arisen,,arisen,1,1,2,1,1,2,11,0.183665,0.192684,305.652501,8,0.000174
n907,modified,,modified,3,3,6,3,3,6,10,0.224908,0.241856,6279.816856,5,0.000398
n908,version,,version,3,3,6,3,3,6,11,0.194251,0.205569,12796.577885,5,0.000423
n909,methods,,methods,5,6,11,6,6,12,10,0.215925,0.231994,18152.175478,16,0.000665
n910,course,,course,3,3,6,3,3,6,11,0.208696,0.222411,10442.07086,7,0.000425
n911,midwestern,,midwestern,1,1,2,1,1,2,13,0.13799,0.142077,2567.004762,7,0.000179
n912,university,,university,1,1,2,1,1,2,12,0.16001,0.166134,2579.004762,7,0.000211
n913,united,,united,4,1,5,4,4,8,11,0.190391,0.200608,11540.872464,14,0.000575
n914,states,,states,2,5,7,5,5,10,10,0.235079,0.255093,20558.606038,14,0.000642
n915,study20,,study20,1,1,2,1,1,2,11,0.1911,0.201894,105.217788,18,0.000159
n916,4year,,4year,1,1,2,1,1,2,12,0.148294,0.153137,2895.61582,1,0.000152
n917,olds,,olds,1,1,2,1,1,2,11,0.174054,0.18167,2907.61582,1,0.000188
n918,child,,child,4,3,7,4,4,8,10,0.210647,0.2243,11873.749332,1,0.000518
n919,centre,,centre,2,3,5,3,3,6,13,0.156891,0.16346,17903.549728,1,0.000388
n920,midwest,,midwest,1,1,2,1,1,2,12,0.180502,0.189229,2997.194698,7,0.000169
n921,taught,,taught,4,4,8,4,4,8,11,0.220165,0.236356,15263.810101,7,0.000602
n922,preservice,,preservice,4,2,6,4,4,8,11,0.218721,0.235209,8223.835448,7,0.000527
n923,enrolled,,enrolled,1,1,2,1,1,2,12,0.172708,0.180361,706.208804,7,0.000157
n924,majors,,majors,1,1,2,1,1,2,11,0.188726,0.199106,247.894614,23,0.000142
n925,field,,field,4,3,7,4,4,8,10,0.216965,0.232709,10078.204076,23,0.000477
n926,requirement,,requirement,1,1,2,1,1,2,12,0.17272,0.180374,375.890549,7,0.000162
n927,lesson,,lesson,5,5,10,5,5,10,10,0.219075,0.234858,13521.30195,7,0.000623
n928,plans,,plans,2,2,4,2,2,4,11,0.204768,0.217371,3870.789874,7,0.000279
n929,interaction,,interaction,9,11,20,11,11,22,11,0.217775,0.235749,53829.075007,23,0.00136
n930,adults,,adults,6,8,14,8,8,16,10,0.23747,0.25796,35615.342756,2,0.000908
n931,reflections,,reflections,1,1,2,1,1,2,12,0.176471,0.184458,1194.041668,5,0.000148
n932,assigned,,assigned,2,2,4,2,2,4,11,0.214214,0.228723,7681.980693,5,0.000296
n933,voluntary,,voluntary,1,1,2,1,1,2,12,0.16814,0.175345,264.707818,7,0.000162
n934,first,,first,5,5,10,5,5,10,11,0.202077,0.214989,22896.067004,7,0.000636
n935,classes,,classes,2,2,4,2,2,4,12,0.18016,0.189556,7472.138197,7,0.000318
n936,specifically,,specifically,3,3,6,3,3,6,10,0.210976,0.224344,9345.34948,23,0.000325
n937,outdoor,,outdoor,4,3,7,4,4,8,11,0.223947,0.24022,2778.41251,23,0.000435
n938,acreage,,acreage,1,1,2,1,1,2,12,0.180312,0.188928,2132.212172,15,0.000169
n939,exploratory,,exploratory,2,2,4,2,2,4,10,0.229265,0.247194,4358.162112,15,0.000298
n940,preschoolers,,preschoolers,10,8,18,10,10,20,11,0.199565,0.212823,38996.168101,2,0.001315
n941,frequently,,frequently,4,3,7,4,4,8,11,0.182244,0.192015,12721.303521,10,0.00062
n942,observed,,observed,3,4,7,4,4,8,11,0.181433,0.191652,24038.574148,10,0.000513
n943,climbing,,climbing,1,1,2,1,1,2,14,0.123414,0.126769,5159.990023,2,0.000168
n944,logs,,logs,1,1,2,1,1,2,13,0.140743,0.145519,5171.990023,2,0.000202
n945,wood,,wood,2,2,4,2,2,4,12,0.163734,0.171251,12838.65,2,0.000408
n946,aesthetically,,aesthetically,1,1,2,1,1,2,11,0.175338,0.183486,3391.467963,2,0.000232
n947,placed,,placed,3,3,6,3,3,6,10,0.212495,0.227411,11960.437981,2,0.00047
n948,grounds,,grounds,1,1,2,1,1,2,11,0.200578,0.212332,397.456362,2,0.000192
n949,building,,building,6,6,12,6,6,12,10,0.250806,0.274858,21834.103295,2,0.000794
n950,dam,,dam,1,1,2,1,1,2,11,0.176349,0.184781,125.971433,2,0.000171
n951,ditch,,ditch,1,1,2,1,1,2,14,0.123414,0.126769,5074.659977,2,0.000177
n952,pieces,,pieces,1,1,2,1,1,2,13,0.140743,0.145519,5086.659977,2,0.000209
n953,chasing,,chasing,1,1,2,1,1,2,12,0.149947,0.155186,2645.982796,2,0.000173
n954,frog,,frog,1,1,2,1,1,2,11,0.176337,0.184771,2657.982796,2,0.000206
n955,space,,space,2,2,4,2,2,4,11,0.194855,0.206426,1137.20164,9,0.000303
n956,crevice,,crevice,1,1,2,1,1,2,12,0.157055,0.163138,1294.681555,14,0.000152
n957,spiders,,spiders,1,1,2,1,1,2,10,0.224731,0.241996,5015.579463,12,0.000157
n958,excited,,excited,1,1,2,1,1,2,11,0.193958,0.205859,637.158083,23,0.000152
n959,independence,,independence,1,1,2,1,1,2,11,0.20138,0.212792,193.817577,3,0.000164
n960,learn,,learn,8,8,16,8,8,16,10,0.252061,0.275372,23748.958325,3,0.000926
n961,discovery,,discovery,5,4,9,5,5,10,10,0.210855,0.22465,10897.42503,19,0.000617
n962,session,,session,1,1,2,1,1,2,11,0.178346,0.186847,170.845791,23,0.000164
n963,planned,,planned,2,2,4,2,2,4,11,0.186087,0.195476,726.608817,7,0.00026
n964,incorporate,,incorporate,4,4,8,4,4,8,11,0.206199,0.219633,11708.044675,16,0.00048
n965,topics,,topics,1,1,2,1,1,2,14,0.119731,0.122572,5115.375,16,0.000161
n966,plant,,plant,1,1,2,1,1,2,13,0.135967,0.139862,5127.375,16,0.000196
n967,animal,,animal,1,1,2,1,1,2,12,0.157295,0.163085,5139.375,16,0.000225
n968,characteristics,,characteristics,2,2,4,2,2,4,11,0.18656,0.19616,12815.902632,16,0.000356
n969,habitats,,habitats,1,1,2,1,1,2,11,0.204605,0.217028,2487.141905,16,0.00021
n970,related,,related,8,9,17,9,9,18,10,0.235813,0.256072,56472.938816,12,0.00097
n971,landscape,,landscape,2,2,4,2,2,4,10,0.237976,0.257974,2212.074872,18,0.000254
n972,attribute,,attribute,1,1,2,1,1,2,12,0.15526,0.160888,2566.571429,5,0.000155
n973,success,,success,1,1,2,1,1,2,11,0.183744,0.19292,2578.571429,5,0.00019
n974,robust,,robust,2,2,4,2,2,4,10,0.239865,0.259625,8257.534785,1,0.000338
n975,namely,,namely,1,1,2,1,1,2,11,0.200547,0.212126,139.526012,16,0.000156
n976,engage,,engage,7,8,15,8,8,16,10,0.250757,0.274475,27137.80084,21,0.000889
n977,explain,,explain,4,5,9,5,5,10,11,0.201144,0.215046,16901.611333,21,0.00053
n978,elaborate,,elaborate,2,2,4,2,2,4,11,0.197569,0.209404,1007.210819,14,0.000252
n979,evaluate,,evaluate,4,4,8,4,4,8,10,0.237536,0.257919,12714.608385,0,0.000461
n980,description,,description,2,2,4,2,2,4,11,0.186411,0.196158,3106.165159,0,0.00031
n981,purpose,,purpose,4,7,11,6,7,13,11,0.20339,0.217223,22464.829712,9,0.000711
n982,presented,,presented,3,3,6,3,3,6,11,0.209121,0.222397,13108.181406,22,0.000474
n983,text,,text,1,1,2,1,1,2,11,0.179756,0.188216,205.275664,7,0.000158
n984,interpreted,,interpreted,1,1,2,1,1,2,11,0.194325,0.205401,1152.972173,8,0.000169
n985,perceived,,perceived,1,1,2,1,1,2,14,0.128619,0.131886,5109,22,0.000156
n986,cultural–historical,,cultural–historical,1,1,2,1,1,2,13,0.147552,0.152231,5121,22,0.000192
n987,viewpoint,,viewpoint,1,1,2,1,1,2,12,0.173023,0.180386,5133,22,0.000222
n988,section,,section,1,0,1,1,0,1,0,0,0,0,22,0.000178
n989,trundleetal2010,,trundleetal2010,1,1,2,1,1,2,11,0.190858,0.201068,286.174825,12,0.000146
n990,importance,,importance,3,3,6,3,3,6,10,0.241967,0.262344,10936.418503,8,0.000382
n991,contemporary,,contemporary,2,2,4,2,2,4,10,0.234242,0.253085,6322.422049,4,0.000262
n992,intuitive,,intuitive,3,3,6,4,4,8,10,0.226455,0.243844,11876.990295,7,0.000543
n993,gopnik2012,,gopnik2012,1,1,2,1,1,2,11,0.194119,0.205321,406.205012,20,0.000154
n994,pts,,pts,1,1,2,1,1,2,13,0.150864,0.156114,2555,9,0.00016
n995,kindergartners,,kindergartners,1,1,2,1,1,2,12,0.177593,0.18603,2567,9,0.000195
n996,facilitator,,facilitator,1,1,2,1,1,2,13,0.139626,0.143696,5109.666667,1,0.000163
n997,provocateur,,provocateur,1,1,2,1,1,2,12,0.162224,0.168325,5121.666667,1,0.000197
n998,wien2014,,wien2014,1,1,2,1,1,2,11,0.193548,0.203713,5133.666667,1,0.000227
n999,central,,central,3,3,6,3,3,6,11,0.213768,0.228864,12229.038208,5,0.000351
n1000,tenets,,tenets,3,3,6,3,3,6,11,0.199456,0.211202,7150.880114,5,0.000405
n1001,reformbased,,reformbased,1,1,2,1,1,2,11,0.206797,0.219434,575.285944,5,0.000174
n1002,integration,,integration,2,2,4,2,2,4,11,0.22117,0.236682,2322.825612,3,0.000246
n1003,bransfordetal2000,,bransfordetal2000,1,1,2,1,1,2,10,0.238595,0.258577,910.104545,11,0.000152
n1004,centered,,centered,1,1,2,1,1,2,11,0.201222,0.21308,681.128318,6,0.000152
n1005,topic,,topic,4,5,9,5,5,10,11,0.203422,0.217229,15648.012822,7,0.000599
n1006,broken,,broken,1,1,2,1,1,2,12,0.154095,0.159669,2577.852067,13,0.000161
n1007,smaller,,smaller,1,1,2,1,1,2,11,0.182102,0.191221,2589.852067,13,0.000196
n1008,focused,,focused,4,4,8,4,4,8,11,0.218145,0.234614,14258.318576,4,0.000515
n1009,krajciketal2003,,krajciketal2003,1,1,2,1,1,2,14,0.127622,0.131005,2758.554926,18,0.000154
n1010,a2014,,a2014,1,1,2,1,1,2,13,0.146233,0.151082,2770.554926,18,0.000189
n1011,national,,national,5,3,8,5,5,10,10,0.240022,0.260773,17144.405174,18,0.000663
n1012,association,,association,2,2,4,2,2,4,11,0.208458,0.222705,11126.465679,9,0.00033
n1013,nsta,,nsta,1,1,2,1,1,2,13,0.15511,0.161104,2586.344902,9,0.000199
n1014,stressed,,stressed,1,1,2,1,1,2,12,0.183507,0.193452,2598.344902,9,0.000228
n1015,level,,level,5,5,10,6,6,12,10,0.230686,0.249187,8535.987539,4,0.000662
n1016,order,,order,8,8,16,8,8,16,10,0.23019,0.248634,27091.886815,3,0.000966
n1017,strengthen,,strengthen,2,2,4,2,2,4,10,0.226735,0.24383,687.115523,5,0.000241
n1018,council,,council,1,1,2,1,1,2,12,0.161743,0.168034,4717.560745,18,0.000159
n1019,inclusion,,inclusion,1,1,2,1,1,2,10,0.238617,0.258596,7681,18,0.000194
n1020,nrc20072012,,nrc20072012,1,1,2,1,1,2,12,0.170733,0.178213,43.911275,18,0.000153
n1021,recommended,,recommended,3,3,6,3,3,6,11,0.205819,0.219102,3582.719851,18,0.000389
n1022,drive,,drive,2,2,4,2,2,4,10,0.210285,0.223344,720.340037,5,0.000251
n1023,identifying,,identifying,3,3,6,3,3,6,11,0.199487,0.211428,2377.241747,3,0.00034
n1024,answered,,answered,1,1,2,1,1,2,11,0.196496,0.207589,537.261898,21,0.000145
n1025,conducting,,conducting,2,1,3,2,2,4,11,0.182076,0.191189,1070.459756,13,0.000241
n1026,appropriate,,appropriate,7,8,15,9,9,18,10,0.24286,0.264152,31132.301056,15,0.001012
n1027,tools,,tools,6,7,13,10,10,20,11,0.210216,0.225425,11063.8095,15,0.000849
n1028,equipment,,equipment,1,1,2,1,1,2,10,0.231706,0.250106,953.821149,15,0.000149
n1029,communicate,,communicate,3,3,6,3,3,6,11,0.224182,0.240209,5426.305918,12,0.000357
n1030,nsta2004a,,nsta2004a,1,1,2,1,1,2,12,0.14576,0.150189,5109,16,0.00016
n1031,crucial,,crucial,1,1,2,1,1,2,11,0.170563,0.177394,5121,16,0.000195
n1032,component,,component,1,1,2,1,1,2,10,0.205539,0.217399,5133,16,0.000224
n1033,express,,express,3,3,6,3,3,6,11,0.226955,0.244141,1066.44627,16,0.000344
n1034,unlike,,unlike,1,1,2,1,1,2,11,0.183533,0.192705,1022.327815,21,0.000151
n1035,older,,older,2,1,3,2,2,4,10,0.224711,0.241983,3157.125281,21,0.000287
n1036,reading,,reading,2,2,4,2,2,4,12,0.17112,0.178602,12812.332576,3,0.000335
n1037,writing,,writing,1,1,2,1,1,2,11,0.204459,0.216728,9800.614896,3,0.000201
n1038,beginning,,beginning,1,1,2,1,1,2,12,0.17019,0.177547,694.223233,18,0.000152
n1039,build,,build,3,3,6,3,3,6,11,0.20503,0.218071,7676.288481,18,0.000398
n1040,faced,,faced,2,2,4,2,2,4,11,0.189227,0.199331,5542.986317,12,0.000253
n1041,challenge,,challenge,4,4,8,4,4,8,11,0.21796,0.233655,17203.935893,12,0.000505
n1042,alternative,,alternative,6,4,10,6,6,12,10,0.230873,0.249025,18594.862107,11,0.000809
n1043,encourage,,encourage,4,5,9,4,5,9,10,0.242699,0.265452,14127.961262,21,0.000464
n1044,representation,,representation,3,3,6,3,3,6,10,0.217627,0.233927,2810.401368,11,0.000351
n1045,element,,element,1,1,2,1,1,2,11,0.213024,0.227105,586.371987,1,0.000167
n1046,different,,different,11,11,22,12,12,24,9,0.240359,0.262173,74545.716217,2,0.001499
n1047,visible,,visible,1,1,2,1,1,2,10,0.202956,0.215573,581.516832,16,0.000146
n1048,expressed,,expressed,1,1,2,1,1,2,12,0.176253,0.184287,1092.15004,21,0.000145
n1049,though,,though,2,2,4,2,2,4,11,0.213893,0.228372,4037.149868,21,0.000317
n1050,various,,various,2,2,4,2,2,4,11,0.204394,0.216755,2946.018649,21,0.000287
n1051,visual,,visual,1,1,2,1,1,2,12,0.158744,0.165226,2555,11,0.000171
n1052,arts,,arts,1,1,2,1,1,2,11,0.188615,0.199422,2567,11,0.000204
n1053,drawings,,drawings,1,1,2,1,1,2,12,0.164247,0.171469,36.529902,21,0.000152
n1054,photography,,photography,1,0,1,1,0,1,0,0,0,0,21,0.000158
n1055,collect,,collect,4,3,7,4,4,8,11,0.206199,0.220781,6911.544181,0,0.000442
n1056,analyze,,analyze,2,2,4,3,3,6,11,0.210699,0.225303,823.36619,0,0.000356
n1057,produce,,produce,3,3,6,3,3,6,11,0.211986,0.22656,13124.144035,0,0.000341
n1058,promising,,promising,1,1,2,1,1,2,11,0.1911,0.201894,477.79671,9,0.000159
n1059,studies,,studies,3,3,6,3,3,6,12,0.181561,0.191158,8627.772791,14,0.000369
n1060,help,,help,6,4,10,7,7,14,10,0.234928,0.255878,7707.268503,21,0.000767
n1061,generate,,generate,3,3,6,3,3,6,10,0.222395,0.237875,1977.524785,23,0.000342
n1062,predictions,,predictions,6,7,13,9,9,18,10,0.231853,0.251331,13382.669671,12,0.00095
n1063,effectively,,effectively,2,2,4,2,2,4,11,0.186628,0.196175,3538.683586,10,0.00027
n1064,production,,production,1,1,2,1,1,2,11,0.201364,0.212773,188.000062,3,0.000152
n1065,studied,,studied,5,5,10,5,5,10,11,0.205588,0.219084,18005.969986,6,0.000565
n1066,lehrer,,lehrer,1,1,2,1,1,2,12,0.180578,0.189987,2655.533591,6,0.000155
n1067,schauble2006,,schauble2006,1,1,2,1,1,2,11,0.220278,0.237776,2667.533591,6,0.000191
n1068,overarching,,overarching,2,1,3,2,2,4,12,0.171819,0.17936,2555,5,0.000255
n1069,intent,,intent,1,1,2,2,2,4,11,0.207398,0.220819,2567,5,0.000275
n1070,sparks,,sparks,1,1,2,2,2,4,13,0.149363,0.154679,2591.072306,2,0.00024
n1071,anchors,,anchors,1,1,2,2,2,4,12,0.175518,0.184063,2603.072306,2,0.000263
n1072,conversations,,conversations,2,2,4,3,3,6,11,0.181458,0.190666,3013.046492,2,0.000395
n1073,want,,want,4,2,6,5,5,10,10,0.219281,0.235035,13562.864955,2,0.000647
n1074,structured,,structured,6,6,12,7,7,14,9,0.259106,0.284655,27149.081556,5,0.000828
n1075,intentionally,,intentionally,1,1,2,2,2,4,12,0.17152,0.179736,305.747572,15,0.000239
n1076,adaptable,,adaptable,1,1,2,2,2,4,10,0.217498,0.232745,3078.458932,15,0.000246
n1077,represent,,represent,2,2,4,3,3,6,12,0.178532,0.187306,5976.675271,20,0.000387
n1078,emerging,,emerging,1,1,2,2,2,4,11,0.201285,0.212705,2378.681271,20,0.000278
n1079,accurate,,accurate,1,1,2,2,2,4,12,0.156872,0.163081,2583.947619,20,0.000278
n1080,inaccurate,,inaccurate,1,1,2,2,2,4,11,0.185966,0.19637,2595.947619,20,0.000295
n1081,critiqued,,critiqued,1,1,2,1,1,2,12,0.171899,0.178915,580.185072,23,0.000161
n1082,refined,,refined,2,1,3,2,2,4,11,0.207498,0.219859,5280.366423,23,0.000335
n1083,producing,,producing,1,1,2,2,2,4,11,0.182296,0.191682,634.197167,14,0.000267
n1084,collective,,collective,4,4,8,5,5,10,11,0.224987,0.243067,10485.816262,14,0.000573
n1085,sharedcritiqued,,sharedcritiqued,1,1,2,1,1,2,12,0.171899,0.178915,2120.181351,23,0.000164
n1086,key,,key,10,9,19,11,11,22,10,0.245179,0.267609,65627.932772,19,0.001427
n1087,components,,components,1,1,2,1,1,2,12,0.172592,0.180492,494.948062,19,0.000169
n1088,lpp,,lpp,5,4,9,5,5,10,11,0.208509,0.222857,25143.773946,11,0.000591
n1089,system,,system,4,4,8,5,5,10,12,0.180438,0.190466,10138.954624,11,0.000671
n1090,1,,1,6,6,12,6,6,12,11,0.19368,0.206077,15952.840945,7,0.000687
n1091,augmented,,augmented,1,1,2,1,1,2,12,0.178967,0.187732,721.078622,7,0.000156
n1092,reality,,reality,3,3,6,3,3,6,11,0.217923,0.23431,7101.172335,7,0.000447
n1093,vision,,vision,1,1,2,1,1,2,12,0.171865,0.17928,55.166952,11,0.000168
n1094,record,,record,3,3,6,4,4,8,11,0.207448,0.220711,3871.794097,0,0.000479
n1095,display,,display,2,2,4,2,2,4,11,0.196616,0.208455,7019.965598,24,0.000254
n1096,actions,,actions,2,2,4,2,2,4,12,0.16471,0.171944,3755.565012,2,0.000255
n1097,locations,,locations,2,2,4,2,2,4,11,0.19049,0.200976,4263.07686,2,0.00032
n1098,2,,2,7,7,14,7,7,14,10,0.233264,0.253185,21617.45254,3,0.000795
n1099,translates,,translates,1,1,2,1,1,2,12,0.163723,0.170866,835.633012,3,0.000162
n1100,motion,,motion,7,7,14,7,7,14,11,0.195702,0.208592,33258.66438,11,0.000892
n1101,physics,,physics,4,2,6,4,4,8,11,0.204752,0.217501,9549.226529,18,0.000483
n1102,engine,,engine,1,1,2,1,1,2,13,0.145232,0.149979,2581.100833,12,0.000161
n1103,generates,,generates,1,1,2,1,1,2,12,0.16983,0.17725,2593.100833,12,0.000196
n1104,response,,response,2,2,4,2,2,4,11,0.204459,0.217679,6283.405702,12,0.000337
n1105,sensing,,sensing,1,1,2,1,1,2,11,0.205473,0.219416,0,0,0.000156
n1106,commercially,,commercially,1,1,2,1,1,2,12,0.164531,0.171023,2592.911185,11,0.000167
n1107,available,,available,1,1,2,1,1,2,11,0.196857,0.207878,2604.911185,11,0.000201
n1108,source,,source,1,1,2,1,1,2,11,0.185898,0.195207,391.579527,11,0.000177
n1109,tracking,,tracking,1,1,2,1,1,2,15,0.103825,0.105953,10214,11,0.000167
n1110,pattern,,pattern,1,1,2,1,1,2,14,0.115806,0.118512,10226,11,0.000201
n1111,recognition,,recognition,1,1,2,1,1,2,13,0.130914,0.134575,10238,11,0.00023
n1112,technologies,,technologies,1,1,2,1,1,2,12,0.150554,0.155902,10250,11,0.000254
n1113,kato2006,,kato2006,1,1,2,1,1,2,11,0.177128,0.185774,10262,11,0.000275
n1114,inexpensive,,inexpensive,1,1,2,1,1,2,11,0.187623,0.197087,320.665828,11,0.000164
n1115,virtual,,virtual,1,1,2,1,1,2,12,0.179005,0.187774,147.927864,7,0.000174
n1116,12’,,12’,1,1,2,1,1,2,16,0.100403,0.102319,12765,14,0.000168
n1117,x,,x,1,1,2,1,1,2,15,0.111579,0.113966,12777,14,0.000202
n1118,12,,12,1,1,2,1,1,2,14,0.125556,0.128698,12789,14,0.00023
n1119,’,,’,1,1,2,1,1,2,13,0.143536,0.147962,12801,14,0.000255
n1120,carpet,,carpet,1,1,2,1,1,2,12,0.167526,0.174325,12813,14,0.000276
n1121,front,,front,1,1,2,1,1,2,11,0.201144,0.212885,12825,14,0.000293
n1122,tracked,,tracked,1,1,2,1,1,2,13,0.152903,0.158793,495.223004,11,0.000167
n1123,instantly,,instantly,1,1,2,1,1,2,12,0.178843,0.186657,2946.415947,11,0.000173
n1124,imported,,imported,1,1,2,1,1,2,11,0.217719,0.231856,2958.415947,11,0.000206
n1125,microworld,,microworld,1,1,2,1,1,2,11,0.186628,0.196078,53.174197,11,0.000168
n1126,allows,,allows,7,4,11,7,7,14,10,0.229347,0.247488,12673.380287,21,0.000794
n1127,force,,force,2,2,4,2,2,4,12,0.173151,0.18181,8329.47893,18,0.000281
n1128,simulated,,simulated,1,1,2,1,1,2,11,0.185764,0.196512,386.184013,2,0.000149
n1129,summarize,,summarize,1,1,2,1,1,2,10,0.217498,0.232745,1177.87735,9,0.000166
n1130,started,,started,1,1,2,1,1,2,11,0.193112,0.20389,408.83401,23,0.000152
n1131,activity,,activity,14,15,29,15,15,30,10,0.23924,0.2613,65899.595202,23,0.001767
n1132,prediction,,prediction,2,2,4,2,2,4,12,0.163682,0.170427,7143.466652,21,0.000262
n1133,technology,,technology,1,1,2,1,1,2,12,0.164121,0.170777,2969.497986,21,0.00017
n1134,translated,,translated,1,1,2,1,1,2,11,0.196255,0.207661,2981.497986,21,0.000204
n1135,augmentedreality,,augmentedreality,1,1,2,1,1,2,11,0.188643,0.198538,487.132525,11,0.000155
n1136,animation,,animation,1,1,2,1,1,2,12,0.164121,0.170777,2592.172166,11,0.000168
n1137,combined,,combined,1,1,2,1,1,2,11,0.196255,0.207661,2604.172166,11,0.000202
n1138,symbolic,,symbolic,1,1,2,1,1,2,11,0.194369,0.20492,668.305197,1,0.000167
n1139,marked,,marked,1,1,2,1,1,2,11,0.195598,0.206914,196.602958,1,0.000183
n1140,embodied,,embodied,2,2,4,2,2,4,12,0.154531,0.160636,3597.03179,21,0.00026
n1141,end,,end,2,2,4,2,2,4,11,0.192836,0.203546,3446.774679,7,0.000283
n1142,net,,net,1,1,2,1,1,2,13,0.147629,0.152947,322.874373,18,0.000154
n1143,gamelike,,gamelike,1,1,2,1,1,2,11,0.193987,0.205891,2395.20257,18,0.000178
n1144,6–8,,6–8,1,1,2,1,1,2,11,0.178706,0.187008,2714.452709,10,0.000162
n1145,yearold,,yearold,1,1,2,1,1,2,10,0.217517,0.232764,2726.452709,10,0.000196
n1146,interrogate,,interrogate,1,1,2,1,1,2,10,0.212477,0.22638,447.477635,21,0.000152
n1147,roseberyetal2005,,roseberyetal2005,1,1,2,1,1,2,12,0.188921,0.199052,219.772806,18,0.00015
n1148,refining,,refining,3,3,6,3,3,6,11,0.183141,0.192925,5852.937973,0,0.000391
n1149,participatory,,participatory,4,3,7,4,4,8,11,0.209496,0.224112,13552.398133,0,0.000482
n1150,danish2009,,danish2009,1,1,2,1,1,2,12,0.173233,0.181262,441.088178,0,0.000151
n1151,skits,,skits,1,1,2,1,1,2,10,0.217535,0.232777,4639.563364,21,0.000176
n1152,enact,,enact,2,2,4,2,2,4,11,0.197934,0.20951,2014.287954,23,0.000252
n1153,principle,,principle,2,2,4,2,2,4,11,0.181638,0.191512,6607.035107,17,0.000335
n1154,leverage,,leverage,1,1,2,1,1,2,11,0.169751,0.17697,2503.205945,6,0.000155
n1155,resource,,resource,1,1,2,1,1,2,11,0.175326,0.183083,3502.620845,18,0.000187
n1156,displaying,,displaying,1,1,2,1,1,2,10,0.212512,0.226413,3514.620845,18,0.000218
n1157,builds,,builds,1,1,2,1,1,2,12,0.174362,0.182511,297.575794,4,0.000162
n1158,kind,,kind,3,3,6,3,3,6,10,0.206997,0.219223,5274.158009,4,0.000368
n1159,engagement,,engagement,8,8,16,11,11,22,10,0.236529,0.258098,22466.293136,5,0.001093
n1160,seen,,seen,3,3,6,3,3,6,11,0.202876,0.215542,3689.738351,16,0.000331
n1161,simulations,,simulations,1,1,2,1,1,2,13,0.145537,0.149976,5109,0,0.000161
n1162,colella2000,,colella2000,1,1,2,1,1,2,12,0.170258,0.177092,5121,0,0.000196
n1163,shifts,,shifts,1,1,2,1,1,2,11,0.205095,0.216925,5133,0,0.000226
n1164,trying,,trying,6,6,12,8,8,16,10,0.214967,0.231014,15094.440191,12,0.000848
n1165,desired,,desired,1,1,2,1,1,2,15,0.112361,0.114921,7662.4,0,0.000155
n1166,resultand,,resultand,1,1,2,1,1,2,14,0.12654,0.129939,7674.4,0,0.000191
n1167,affect,,affect,1,1,2,1,1,2,13,0.144815,0.149656,7686.4,0,0.000221
n1168,accompanies,,accompanies,1,1,2,1,1,2,12,0.169259,0.176806,7698.4,0,0.000247
n1169,type,,type,3,3,6,3,3,6,11,0.203632,0.21703,16476.94473,0,0.000508
n1170,activityto,,activityto,1,1,2,1,1,2,11,0.17948,0.188005,368.508703,0,0.000203
n1171,explicitly,,explicitly,2,2,4,2,2,4,10,0.218646,0.234457,3924.929716,0,0.000329
n1172,evaluating,,evaluating,6,6,12,6,6,12,10,0.227418,0.246024,16389.381216,0,0.000737
n1173,rules,,rules,1,1,2,1,1,2,14,0.124951,0.1283,2566.477045,7,0.000163
n1174,underlie,,underlie,1,1,2,1,1,2,13,0.14273,0.14749,2578.477045,7,0.000198
n1175,simulation,,simulation,2,1,3,2,1,3,12,0.166407,0.173827,5372.953703,7,0.000356
n1176,multifaceted,,multifaceted,1,1,2,1,1,2,12,0.147705,0.153075,200.025501,15,0.000149
n1177,aimed,,aimed,1,1,2,1,1,2,12,0.169763,0.177293,0,15,0.000176
n1178,researcher,,researcher,1,1,2,1,1,2,11,0.209753,0.223302,203.106759,15,0.000153
n1179,choice,,choice,1,1,2,1,1,2,12,0.182724,0.191979,1165.176322,5,0.000155
n1180,changes,,changes,2,2,4,2,2,4,10,0.213875,0.22813,4321.525398,18,0.000254
n1181,water,,water,4,4,8,4,4,8,10,0.241421,0.261821,12464.446474,18,0.000538
n1182,pedagogically,,pedagogically,1,1,2,1,1,2,11,0.195926,0.206746,1826.862341,22,0.00013
n1183,single,,single,4,4,8,4,4,8,10,0.224613,0.242362,10300.682926,16,0.000524
n1184,garritz2012,,garritz2012,1,1,2,1,1,2,12,0.163661,0.170068,2592.917389,18,0.000175
n1185,newmanetal2004,,newmanetal2004,1,1,2,1,1,2,11,0.195612,0.206496,2604.917389,18,0.000208
n1186,characterized,,characterized,2,2,4,2,2,4,11,0.195196,0.206386,2350.618879,16,0.000255
n1187,…,,…,1,1,2,1,1,2,11,0.18787,0.197586,89.734312,5,0.000153
n1188,progressively,,progressively,2,2,4,2,2,4,11,0.194915,0.206144,2889.8518,7,0.000242
n1189,employed,,employed,3,3,6,3,3,6,11,0.212231,0.227361,4497.153089,5,0.000341
n1190,raising,,raising,1,1,2,1,1,2,10,0.216508,0.232195,549.164704,7,0.000154
n1191,collecting,,collecting,2,2,4,2,2,4,11,0.20572,0.220143,2817.442104,0,0.000257
n1192,already,,already,2,1,3,2,2,4,11,0.193432,0.203925,1754.78658,20,0.000295
n1193,known,,known,3,4,7,4,4,8,10,0.239709,0.260264,11493.686863,20,0.000537
n1194,drawing,,drawing,3,3,6,3,3,6,11,0.190236,0.201366,8936.300552,20,0.000394
n1195,interacademy,,interacademy,1,1,2,1,1,2,14,0.133147,0.136805,5109.520833,2,0.000155
n1196,partnership,,partnership,1,1,2,1,1,2,13,0.153533,0.158892,5121.520833,2,0.000191
n1197,iap2010p19,,iap2010p19,1,1,2,1,1,2,12,0.181292,0.189969,5133.520833,2,0.000221
n1198,among,,among,3,3,6,3,3,6,11,0.221303,0.237569,10936.880842,2,0.000419
n1199,perspective,,perspective,2,2,4,2,2,4,10,0.23769,0.25749,7122.213993,23,0.00032
n1200,requires,,requires,2,2,4,2,2,4,11,0.207348,0.220581,2346.135074,12,0.000256
n1201,exa,,exa,2,2,4,2,2,4,11,0.202892,0.215635,11766.206848,12,0.000323
n1202,caamano2012,,caamano2012,1,1,2,1,1,2,13,0.156233,0.162241,2560,12,0.000196
n1203,criadogarcíacarmona2011,,criadogarcíacarmona2011,1,1,2,1,1,2,12,0.185094,0.19493,2572,12,0.000226
n1204,harlen2014,,harlen2014,2,2,4,2,2,4,11,0.227036,0.24567,5577.261927,12,0.000334
n1205,representing,,representing,2,2,4,2,2,4,10,0.214662,0.229434,1340.054826,0,0.000265
n1206,score2013,,score2013,1,1,2,1,1,2,11,0.176543,0.185272,936.503076,13,0.000142
n1207,therefore,,therefore,5,5,10,5,5,10,10,0.235899,0.255919,13265.652023,16,0.000553
n1208,hodson2014,,hodson2014,1,1,2,1,1,2,13,0.144391,0.14907,4446.313684,12,0.000152
n1209,promotion,,promotion,1,1,2,1,1,2,12,0.168714,0.175976,4458.313684,12,0.000188
n1210,seems,,seems,2,2,4,2,2,4,11,0.199938,0.2112,1339.219217,18,0.000281
n1211,agreement,,agreement,2,2,4,2,2,4,10,0.247733,0.26888,2966.898685,18,0.000282
n1212,following,,following,3,3,6,3,3,6,10,0.221723,0.238101,12481.177678,16,0.000371
n1213,ledermanetal2014,,ledermanetal2014,1,1,2,1,1,2,10,0.221992,0.238271,7784.760727,16,0.00021
n1214,inquiries,,inquiries,2,3,5,4,4,8,11,0.199829,0.211641,7179.915129,16,0.000453
n1215,necessarily,,necessarily,1,1,2,1,1,2,12,0.165028,0.171623,282.080667,11,0.000156
n1216,hypothesis,,hypothesis,9,8,17,9,9,18,10,0.224123,0.243434,30030.722336,12,0.001154
n1217,ii,,ii,2,2,4,2,2,4,11,0.201475,0.213018,1770.168767,22,0.000277
n1218,method,,method,5,8,13,9,9,18,10,0.243828,0.266387,28498.088624,16,0.000914
n1219,iii,,iii,2,2,4,2,2,4,10,0.225877,0.242751,4018.589151,16,0.000276
n1220,posed,,posed,2,3,5,3,3,6,11,0.196691,0.208081,5998.8039,12,0.000374
n1221,iv,,iv,1,1,2,1,1,2,10,0.193855,0.204605,536.454054,12,0.000165
n1222,get,,get,2,2,4,2,2,4,10,0.195612,0.207039,2971.989448,15,0.000257
n1223,v,,v,1,1,2,1,1,2,10,0.238617,0.258596,2014.695524,2,0.000155
n1224,influence,,influence,2,2,4,2,2,4,11,0.203454,0.21698,3236.117032,7,0.00026
n1225,vi,,vi,1,1,2,1,1,2,11,0.180185,0.188856,490.661452,12,0.000155
n1226,must,,must,4,4,8,4,4,8,10,0.217609,0.232578,6857.259129,21,0.00045
n1227,consistent,,consistent,2,2,4,2,2,4,10,0.233221,0.252634,3636.19747,0,0.000279
n1228,acquired,,acquired,1,2,3,2,2,4,11,0.184231,0.193568,3930.421692,0,0.000256
n1229,vii,,vii,1,1,2,1,1,2,10,0.221973,0.238251,2101.563545,0,0.000168
n1230,numbers,,numbers,3,3,6,3,3,6,11,0.198393,0.210103,15464.700221,19,0.000366
n1231,descriptions,,descriptions,1,1,2,1,1,2,12,0.153837,0.159302,5111.490217,19,0.000163
n1232,images,,images,1,1,2,1,1,2,11,0.181741,0.19055,5123.490217,19,0.000197
n1233,etc,,etc,1,1,2,1,1,2,10,0.222011,0.238284,5135.490217,19,0.000226
n1234,product,,product,1,1,2,1,1,2,11,0.20544,0.219365,0,0,0.000154
n1235,interpretation,,interpretation,1,1,2,1,1,2,11,0.171784,0.179046,2695.024242,17,0.000177
n1236,viii,,viii,1,1,2,1,1,2,10,0.207331,0.220129,2707.024242,17,0.00021
n1237,combination,,combination,1,1,2,1,1,2,11,0.205473,0.219416,792.797195,0,0.000155
n1238,phenomenon,,phenomenon,3,3,6,3,3,6,10,0.196255,0.207794,4654.269517,5,0.000346
n1239,mentioned,,mentioned,1,1,2,1,1,2,11,0.183141,0.193024,336.583348,5,0.000157
n1240,formulation,,formulation,1,1,2,1,1,2,12,0.160963,0.167337,220.83304,8,0.000168
n1241,even,,even,4,4,8,4,4,8,11,0.209479,0.22298,16623.833969,21,0.000633
n1242,hypotheses,,hypotheses,9,9,18,9,9,18,11,0.20278,0.217625,26109.309124,12,0.001091
n1243,statements,,statements,2,2,4,2,2,4,12,0.173643,0.182332,3663.071281,12,0.000258
n1244,tentative,,tentative,1,1,2,1,1,2,12,0.179518,0.188119,459.239859,12,0.000168
n1245,depending,,depending,1,1,2,1,1,2,10,0.20544,0.217562,392.630477,16,0.00015
n1246,three,,three,8,7,15,8,9,17,10,0.21578,0.231444,51269.628059,14,0.000977
n1247,types,,types,3,3,6,3,3,6,10,0.246496,0.268691,13622.837242,12,0.000382
n1248,distinguished,,distinguished,1,1,2,1,1,2,13,0.135794,0.139851,2728.692473,15,0.000145
n1249,guisasolaetal2006,,guisasolaetal2006,1,1,2,1,1,2,12,0.157074,0.163162,2740.692473,15,0.000182
n1250,stating,,stating,1,1,2,1,1,2,11,0.171532,0.17956,301.459579,12,0.000162
n1251,yet,,yet,4,4,8,4,4,8,10,0.234799,0.254342,12876.009514,12,0.000537
n1252,confirmed,,confirmed,1,1,2,1,1,2,11,0.183141,0.193024,208.870908,12,0.000173
n1253,factual,,factual,1,1,2,1,1,2,10,0.218145,0.23364,361.815822,12,0.00015
n1254,events,,events,3,3,6,3,3,6,11,0.200672,0.213576,8620.60731,11,0.000413
n1255,factsexplanatory,,factsexplanatory,1,1,2,1,1,2,12,0.168648,0.17665,469.196137,23,0.000151
n1256,speculating,,speculating,1,1,2,1,1,2,12,0.151809,0.157168,2585.367227,12,0.000162
n1257,reasons,,reasons,1,1,2,1,1,2,11,0.178942,0.187609,2597.367227,12,0.000197
n1258,bwhy,,bwhy,1,1,2,1,1,2,10,0.207297,0.220097,828.424725,11,0.000152
n1259,theories…,,theories…,1,1,2,1,1,2,11,0.18827,0.198207,344.539942,0,0.000151
n1260,deductive,,deductive,1,1,2,1,1,2,11,0.192836,0.204166,209.614867,16,0.000168
n1261,predicted,,predicted,5,4,9,5,5,10,11,0.175951,0.185588,19076.633716,2,0.000558
n1262,reached,,reached,1,1,2,1,1,2,11,0.183154,0.193037,918.964995,0,0.000187
n1263,trueprocedural,,trueprocedural,1,1,2,1,1,2,12,0.168648,0.17665,317.024657,12,0.000168
n1264,referring,,referring,1,1,2,1,1,2,10,0.218163,0.23366,1375.892348,12,0.000162
n1265,bhow,,bhow,1,1,2,1,1,2,12,0.157517,0.163567,1050.230101,12,0.000152
n1266,measurements,,measurements,2,2,4,2,2,4,11,0.187145,0.197572,2791.65159,12,0.000239
n1267,procedural,,procedural,1,1,2,1,1,2,10,0.208003,0.221719,833.034703,12,0.00016
n1268,modifying,,modifying,1,1,2,1,1,2,12,0.154839,0.160695,624.560985,0,0.00015
n1269,test,,test,3,3,6,3,3,6,10,0.210027,0.223785,21490.696184,0,0.000497
n1270,measurement,,measurement,2,2,4,2,2,4,11,0.209035,0.22373,2190.541775,0,0.000312
n1271,breakconfirmation,,breakconfirmation,1,1,2,1,1,2,10,0.238573,0.258544,845.869628,16,0.000153
n1272,indicates,,indicates,1,1,2,1,1,2,12,0.153772,0.15967,0,12,0.000169
n1273,procedure,,procedure,3,4,7,4,4,8,11,0.181664,0.19164,25372.600114,12,0.000666
n1274,follow,,follow,3,3,6,3,3,6,10,0.215093,0.229048,19716.979784,22,0.000433
n1275,obtain,,obtain,3,4,7,5,5,10,10,0.245624,0.267524,13357.762784,21,0.000576
n1276,beforehand,,beforehand,1,1,2,1,1,2,11,0.187186,0.196643,125.161995,20,0.000173
n1277,either,,either,2,2,4,4,4,8,11,0.18575,0.195531,3647.132627,12,0.00042
n1278,acquisition,,acquisition,1,1,2,1,1,2,11,0.192706,0.202979,2592.389505,0,0.000158
n1279,organizationstructured,,organizationstructured,1,1,2,1,1,2,10,0.238617,0.258596,2604.389505,0,0.000193
n1280,recorded,,recorded,1,1,2,1,1,2,11,0.204915,0.218265,0,0,0.000158
n1281,provideguidedinquirythepupils,,provideguidedinquirythepupils,1,1,2,1,1,2,14,0.109212,0.111519,7662,0,0.000158
n1282,nowdesignand,,nowdesignand,1,1,2,1,1,2,13,0.12256,0.125574,7674,0,0.000193
n1283,followtheirownprocedures,,followtheirownprocedures,1,1,2,1,1,2,12,0.139626,0.143841,7686,0,0.000223
n1284,collectdataand,,collectdataand,1,1,2,1,1,2,11,0.162213,0.168652,7698,0,0.000248
n1285,teacheropen,,teacheropen,1,1,2,1,1,2,10,0.238595,0.258577,2165.754632,12,0.000165
n1286,formulate,,formulate,4,4,8,4,4,8,10,0.222203,0.239672,8911.299274,12,0.000437
n1287,procedures,,procedures,4,4,8,4,4,8,10,0.206215,0.21929,6955.041597,5,0.000439
n1288,report,,report,4,3,7,4,4,8,10,0.213555,0.226899,6994.269128,12,0.000547
n1289,findings,,findings,7,7,14,7,7,14,10,0.224436,0.241408,13093.347543,12,0.000796
n1290,describe,,describe,2,3,5,2,3,5,10,0.243944,0.265636,8302.80463,16,0.000247
n1291,area,,area,3,3,6,3,3,6,11,0.20025,0.212484,8228.81006,5,0.00045
n1292,menmuiradams1997processes,,menmuiradams1997processes,1,1,2,1,1,2,11,0.214895,0.229605,1762.63799,5,0.000186
n1293,inconjunction,,inconjunction,1,1,2,1,1,2,11,0.196887,0.208237,206.790761,6,0.000155
n1294,mathematics,,mathematics,6,7,13,8,8,16,10,0.245062,0.267992,30588.762764,5,0.000908
n1295,epstein2007,,epstein2007,2,2,4,2,2,4,11,0.180324,0.188906,3104.153593,3,0.000242
n1296,french2004gerdeetal2013menmuiradams1997,,french2004gerdeetal2013menmuiradams1997,1,1,2,1,1,2,11,0.204459,0.216728,1132.631961,3,0.000162
n1297,afford,,afford,1,1,2,1,1,2,12,0.166418,0.173678,235.111709,13,0.000151
n1298,theirinherent,,theirinherent,1,1,2,1,1,2,12,0.161713,0.167893,49.020932,18,0.000172
n1299,fascination,,fascination,2,2,4,2,2,4,11,0.192822,0.203337,5227.766601,18,0.000292
n1300,collaborations,,collaborations,1,1,2,1,1,2,15,0.117287,0.120178,10214,23,0.000154
n1301,‘experiencerich,,‘experiencerich,1,1,2,1,1,2,14,0.132816,0.136753,10226,23,0.00019
n1302,languagerich,,languagerich,1,1,2,1,1,2,13,0.153085,0.158868,10238,23,0.00022
n1303,environments’,,environments’,1,1,2,1,1,2,12,0.180654,0.190025,10250,23,0.000246
n1304,french2004p147,,french2004p147,1,1,2,1,1,2,11,0.220335,0.237797,10262,23,0.000268
n1305,just,,just,5,5,10,5,5,10,10,0.213112,0.226806,23394.323588,20,0.0007
n1306,static,,static,2,2,4,2,2,4,12,0.179782,0.189132,1489.772654,11,0.000312
n1307,prescribed,,prescribed,2,2,4,2,2,4,11,0.202524,0.215343,1902.755528,11,0.000291
n1308,units,,units,3,3,6,3,3,6,11,0.222936,0.241218,2946.687653,3,0.000365
n1309,big,,big,3,2,5,3,3,6,11,0.217277,0.232304,7224.671186,16,0.000389
n1310,gelmanbrenneman2012,,gelmanbrenneman2012,2,2,4,2,2,4,12,0.187706,0.197997,9649.267148,3,0.000283
n1311,wasserman2015,,wasserman2015,1,1,2,1,1,2,12,0.175662,0.183557,2651.031895,3,0.000179
n1312,constructive,,constructive,1,1,2,1,1,2,11,0.213024,0.227105,2663.031895,3,0.000211
n1313,approaches,,approaches,2,2,4,2,2,4,11,0.207565,0.22077,4587.385806,4,0.000286
n1314,french2004,,french2004,3,3,6,3,3,6,11,0.195107,0.206316,5757.593121,3,0.000345
n1315,gelmanetal2010,,gelmanetal2010,1,1,2,1,1,2,12,0.187623,0.197588,134.653298,3,0.000157
n1316,greenfieldetal2009,,greenfieldetal2009,3,3,6,3,3,6,11,0.230852,0.250088,8899.009951,3,0.000409
n1317,inanetal2010,,inanetal2010,4,4,8,4,4,8,11,0.204231,0.217007,13967.033248,3,0.000476
n1318,addition,,addition,2,3,5,2,3,5,10,0.226176,0.242797,1724.599582,3,0.00026
n1319,cyclic,,cyclic,1,1,2,1,1,2,10,0.224672,0.241931,831.605172,21,0.000146
n1320,continue,,continue,1,1,2,1,1,2,10,0.211428,0.224179,0,21,0.000152
n1321,seek,,seek,2,2,4,2,2,4,10,0.228206,0.245732,3843.25624,11,0.000262
n1322,apply,,apply,2,2,4,2,2,4,10,0.218907,0.234702,3094.9525,13,0.00028
n1323,emergent,,emergent,4,3,7,4,4,8,10,0.23538,0.254786,7030.810185,23,0.000537
n1324,gelmanbrenneman2004,,gelmanbrenneman2004,1,1,2,1,1,2,10,0.221189,0.236901,303.752655,16,0.000144
n1325,enables,,enables,1,1,2,1,1,2,10,0.224692,0.241963,956.863382,21,0.000151
n1326,integrate,,integrate,1,1,2,1,1,2,11,0.191814,0.201955,2555,21,0.000152
n1327,languageliteracymathand,,languageliteracymathand,1,1,2,1,1,2,10,0.237272,0.256806,2567,21,0.000188
n1328,gerdeetal2013,,gerdeetal2013,4,4,8,4,4,8,10,0.20941,0.222751,5613.357621,3,0.000455
n1329,linking,,linking,2,2,4,2,2,4,12,0.179242,0.187346,15573.97109,3,0.000273
n1330,extant,,extant,1,1,2,1,1,2,11,0.217738,0.231869,2815.97109,3,0.000175
n1331,bjorklund2011,,bjorklund2011,1,1,2,1,1,2,13,0.158089,0.164236,147.474675,3,0.000153
n1332,paper,,paper,1,2,3,1,2,3,11,0.205325,0.217597,617.174456,7,0.000145
n1333,detailed,,detailed,1,1,2,1,1,2,11,0.17529,0.18327,45.347896,7,0.000156
n1334,case,,case,3,2,5,3,3,6,10,0.21246,0.226871,7282.312208,7,0.000426
n1335,implemented,,implemented,2,2,4,2,2,4,11,0.197919,0.210216,3045.410008,6,0.00025
n1336,forensic,,forensic,1,1,2,1,1,2,10,0.237272,0.256806,1513.819347,6,0.000165
n1337,fouryearold,,fouryearold,2,2,4,2,2,4,11,0.222145,0.238034,1736.12625,14,0.000241
n1338,participants,,participants,5,5,10,5,5,10,10,0.250683,0.274121,15457.93845,23,0.000579
n1339,platform,,platform,2,2,4,3,3,6,10,0.211532,0.224588,5130.315529,18,0.000374
n1340,prepared,,prepared,1,1,2,1,1,2,11,0.208984,0.222314,0,5,0.000157
n1341,hackling2007,,hackling2007,2,2,4,2,2,4,11,0.213041,0.227345,5426.606896,5,0.000258
n1342,manipulation,,manipulation,2,2,4,2,2,4,11,0.207885,0.222481,1299.998953,23,0.000245
n1343,gaining,,gaining,1,1,2,1,1,2,10,0.218108,0.233606,569.24567,5,0.000164
n1344,heart,,heart,1,1,2,1,1,2,11,0.213006,0.227086,0,5,0.000169
n1345,crawford2009,,crawford2009,1,1,2,1,1,2,11,0.205967,0.218933,134.424322,7,0.000162
n1346,engages,,engages,1,1,2,1,1,2,10,0.21748,0.232712,596.000582,21,0.000166
n1347,encourages,,encourages,2,2,4,2,2,4,11,0.180947,0.190068,17051.600557,3,0.000248
n1348,excitement,,excitement,1,1,2,1,1,2,11,0.174196,0.18181,141.074297,19,0.000157
n1349,supports,,supports,1,1,2,1,1,2,10,0.217498,0.232745,446.351356,21,0.000151
n1350,working,,working,4,4,8,4,4,8,10,0.225007,0.242649,8245.041567,23,0.00046
n1351,scientist,,scientist,1,1,2,1,1,2,12,0.152948,0.158408,68.724921,12,0.000155
n1352,crawford2007,,crawford2007,2,2,4,2,2,4,11,0.210233,0.223187,3170.552113,1,0.00026
n1353,appears,,appears,2,2,4,2,2,4,12,0.174161,0.183034,6815.51277,14,0.000256
n1354,provides,,provides,2,3,5,3,3,6,10,0.211689,0.225611,2399.31184,5,0.000323
n1355,collection,,collection,1,1,2,1,1,2,11,0.20347,0.215674,104.168646,5,0.00016
n1356,hackling2005,,hackling2005,2,1,3,2,2,4,10,0.205506,0.217376,467.508231,16,0.000244
n1357,hedges2000,,hedges2000,1,1,2,1,1,2,11,0.20977,0.223322,301.988662,23,0.000156
n1358,involve,,involve,2,2,4,2,2,4,11,0.175542,0.183329,7768.127146,1,0.000284
n1359,manipulating,,manipulating,1,1,2,1,1,2,11,0.187939,0.198034,1401.294076,1,0.00018
n1360,recording,,recording,4,4,8,4,4,8,11,0.225322,0.243198,6197.273291,12,0.000465
n1361,interpreting,,interpreting,2,2,4,2,2,4,11,0.204361,0.216881,3265.289667,12,0.00026
n1362,acknowledges,,acknowledges,2,2,4,3,3,6,11,0.197873,0.209833,5556.530068,23,0.000323
n1363,‘active,,‘active,1,1,2,1,1,2,15,0.106151,0.108375,10214,9,0.000152
n1364,agents,,agents,1,1,2,1,1,2,14,0.118713,0.121579,10226,9,0.000188
n1365,communicators,,communicators,1,1,2,1,1,2,13,0.134648,0.138587,10238,9,0.000219
n1366,learning’,,learning’,1,1,2,1,1,2,12,0.155523,0.161403,10250,9,0.000245
n1367,hedges2000p18,,hedges2000p18,1,1,2,1,1,2,11,0.18406,0.193868,10262,9,0.000267
n1368,issues,,issues,2,2,4,2,2,4,10,0.206365,0.218862,2350.982971,14,0.00028
n1369,select,,select,1,1,2,1,1,2,11,0.195449,0.206085,1370.044625,15,0.00015
n1370,samarapungavanetal2008,,samarapungavanetal2008,3,3,6,3,3,6,11,0.183258,0.193484,4608.933846,14,0.000387
n1371,commented,,commented,1,1,2,1,1,2,12,0.183494,0.193443,133.272511,14,0.000155
n1372,‘universal,,‘universal,1,1,2,1,1,2,13,0.131949,0.135577,7662,21,0.000152
n1373,novices’,,novices’,1,1,2,1,1,2,12,0.151962,0.157242,7674,21,0.000188
n1374,p903,,p903,1,1,2,1,1,2,11,0.179129,0.187584,7686,21,0.000219
n1375,lacking,,lacking,1,1,2,1,1,2,10,0.218126,0.233619,7698,21,0.000245
n1376,discipline,,discipline,1,1,2,1,1,2,11,0.184403,0.194059,390.315082,3,0.000152
n1377,numeracy,,numeracy,1,1,2,1,1,2,11,0.208984,0.222314,282.807422,20,0.000151
n1378,included,,included,1,1,2,1,1,2,12,0.163577,0.169996,12715.065946,5,0.00015
n1379,modelling,,modelling,2,2,4,2,2,4,11,0.195493,0.206431,20481.325533,5,0.000379
n1380,guiding,,guiding,1,1,2,1,1,2,10,0.237251,0.256774,0,18,0.00015
n1381,discourse,,discourse,10,7,17,10,10,20,10,0.25358,0.279511,51826.693101,23,0.00142
n1382,assisting,,assisting,2,2,4,3,3,6,11,0.220827,0.236492,1183.450717,5,0.000356
n1383,better,,better,2,2,4,3,3,6,10,0.216071,0.230922,3691.697943,21,0.000386
n1384,outcomes,,outcomes,2,2,4,2,2,4,10,0.238706,0.258953,3286.171853,2,0.000246
n1385,relevant,,relevant,4,4,8,4,4,8,10,0.212266,0.226216,8488.498517,14,0.000451
n1386,located,,located,1,1,2,1,1,2,12,0.154932,0.160975,82.519574,14,0.000163
n1387,examined,,examined,3,3,6,3,3,6,11,0.195523,0.207372,7363.153229,14,0.000441
n1388,kindergarten,,kindergarten,4,3,7,4,4,8,10,0.234029,0.254711,9414.740596,21,0.000567
n1389,monarch,,monarch,1,1,2,1,1,2,12,0.15671,0.163119,2595.319481,2,0.000143
n1390,butterfly,,butterfly,1,1,2,1,1,2,11,0.185764,0.196512,2607.319481,2,0.000181
n1391,indicated,,indicated,1,1,2,1,1,2,11,0.189702,0.200272,369.48086,2,0.000155
n1392,successfully,,successfully,3,2,5,3,3,6,11,0.201459,0.213663,1276.194441,21,0.000335
n1393,conduct,,conduct,4,4,8,4,4,8,10,0.206116,0.219995,9023.943282,13,0.000453
n1394,extend,,extend,3,3,6,3,3,6,11,0.198301,0.210372,7908.361531,14,0.000364
n1395,revise,,revise,3,3,6,3,3,6,10,0.219281,0.235778,7324.444667,14,0.000435
n1396,measured,,measured,1,1,2,1,1,2,12,0.173901,0.18204,477.321461,17,0.000152
n1397,portfolios,,portfolios,1,1,2,1,1,2,11,0.198792,0.210108,415.469044,17,0.000177
n1398,highly,,highly,1,1,2,1,1,2,11,0.168272,0.175303,1618.203271,12,0.000152
n1399,proficient,,proficient,2,2,4,2,2,4,10,0.202237,0.214582,2635.552413,12,0.000285
n1400,generating,,generating,3,2,5,3,3,6,10,0.228531,0.24681,5294.247377,12,0.000402
n1401,observing,,observing,3,3,6,3,3,6,11,0.20693,0.220324,2935.292209,12,0.000341
n1402,communicating,,communicating,3,3,6,3,3,6,10,0.22945,0.247253,2632.639684,0,0.000361
n1403,peterson,,peterson,1,1,2,1,1,2,13,0.14062,0.14507,2565.741667,14,0.000168
n1404,french2008,,french2008,1,1,2,1,1,2,12,0.163588,0.170415,2577.741667,14,0.000202
n1405,explanatory,,explanatory,1,1,2,1,1,2,11,0.200829,0.21292,235.297054,18,0.000158
n1406,fiveweek,,fiveweek,1,1,2,1,1,2,11,0.17498,0.182961,1108.494078,3,0.00015
n1407,colour,,colour,1,1,2,1,1,2,13,0.148208,0.153327,2564.666667,17,0.000159
n1408,mixing,,mixing,1,1,2,1,1,2,12,0.173925,0.182062,2576.666667,17,0.000194
n1409,conversational,,conversational,1,1,2,1,1,2,11,0.181741,0.19055,2555,21,0.000153
n1410,partners,,partners,1,1,2,1,1,2,10,0.222011,0.238284,2567,21,0.000189
n1411,investigators,,investigators,2,2,4,2,2,4,12,0.1567,0.162647,7811.925833,2,0.000245
n1412,dynamic,,dynamic,1,1,2,1,1,2,11,0.171761,0.179023,3479.424334,2,0.000163
n1413,coconstructors,,coconstructors,1,1,2,1,1,2,10,0.207314,0.220116,3491.424334,2,0.000197
n1414,demonstrate,,demonstrate,1,1,2,1,1,2,11,0.1911,0.201894,257.237761,2,0.000155
n1415,literate,,literate,1,1,2,1,1,2,11,0.177581,0.186077,1946.821991,3,0.000152
n1416,introduce,,introduce,2,1,3,2,2,4,10,0.224692,0.241963,332.574533,21,0.000273
n1417,curious,,curious,2,2,4,2,2,4,11,0.194737,0.207136,3559.400488,15,0.000264
n1418,surrounding,,surrounding,1,1,2,1,1,2,10,0.224692,0.241963,576.192176,12,0.000145
n1419,easier,,easier,1,1,2,1,1,2,12,0.181024,0.18911,1752.702493,6,0.000144
n1420,concrete,,concrete,3,3,6,3,3,6,10,0.224045,0.241436,10322.252067,10,0.000392
n1421,gain,,gain,2,2,4,2,2,4,10,0.233624,0.252782,5475.567955,10,0.000256
n1422,harlenqualter2004,,harlenqualter2004,1,1,2,1,1,2,11,0.22024,0.237743,425.994366,9,0.000152
n1423,cepnietal2006,,cepnietal2006,1,1,2,1,1,2,11,0.214877,0.229586,2981.667467,9,0.000165
n1424,divided,,divided,1,1,2,1,1,2,11,0.177532,0.185872,669.431122,14,0.000144
n1425,groups,,groups,2,2,4,2,2,4,10,0.202812,0.214695,3062.461537,16,0.000254
n1426,causal,,causal,2,2,4,2,2,4,11,0.215021,0.229946,3616.920728,22,0.00023
n1427,gained,,gained,2,2,4,2,2,4,13,0.151576,0.157288,5451.841821,10,0.000245
n1428,since,,since,1,1,2,1,1,2,13,0.133646,0.137573,2604.623279,10,0.000163
n1429,birth,,birth,1,1,2,1,1,2,12,0.154206,0.160049,2616.623279,10,0.000197
n1430,repeated,,repeated,1,1,2,1,1,2,10,0.202636,0.214182,3709.064683,10,0.000191
n1431,estimation,,estimation,1,1,2,1,1,2,12,0.163849,0.170597,2555,0,0.000146
n1432,classification,,classification,1,1,2,1,1,2,11,0.195881,0.207461,2567,0,0.000183
n1433,problemsolving,,problemsolving,8,7,15,8,8,16,11,0.227076,0.245713,29599.222411,5,0.000978
n1434,howejones1998,,howejones1998,1,1,2,1,1,2,11,0.167843,0.17491,0,16,0.000144
n1435,hypothesizing,,hypothesizing,4,4,8,4,4,8,10,0.201633,0.214179,8689.451641,16,0.000484
n1436,checking,,checking,1,1,2,1,1,2,11,0.214859,0.229553,617.830503,0,0.000158
n1437,advanced,,advanced,1,1,2,1,1,2,11,0.187486,0.19709,552.447075,4,0.000144
n1438,periods,,periods,1,1,2,1,1,2,13,0.141355,0.146293,2566.196361,9,0.000149
n1439,lind2000,,lind2000,1,1,2,1,1,2,12,0.164563,0.172271,2578.196361,9,0.000186
n1440,kefietal2013,,kefietal2013,1,1,2,1,1,2,12,0.170631,0.178805,770.317297,10,0.000165
n1441,ages,,ages,2,2,4,2,2,4,12,0.178,0.186508,7750.729821,10,0.000256
n1442,without,,without,2,2,4,2,2,4,11,0.192952,0.204049,6011.64023,10,0.000339
n1443,sip,,sip,1,1,2,1,1,2,12,0.172999,0.180363,1350.907468,22,0.000166
n1444,“understand,,“understand,3,3,6,3,3,6,10,0.243067,0.263401,8316.88898,22,0.000417
n1445,world”,,world”,2,2,4,2,2,4,11,0.183337,0.192698,2617.458548,22,0.000257
n1446,basis,,basis,7,7,14,8,8,16,10,0.249393,0.273329,32432.583357,20,0.000906
n1447,evaluated,,evaluated,1,1,2,2,2,4,12,0.167679,0.174593,2272.866485,20,0.000244
n1448,correspondence,,correspondence,2,2,4,3,3,6,11,0.201396,0.213442,7849.394133,20,0.000426
n1449,evidence”,,evidence”,1,1,2,1,1,2,11,0.184297,0.193315,318.206132,20,0.000154
n1450,subjects,,subjects,1,1,2,1,1,2,14,0.122983,0.126135,5123.725702,10,0.000151
n1451,hacking19921995,,hacking19921995,1,1,2,1,1,2,13,0.140182,0.144586,5135.725702,10,0.000187
n1452,mapping,,mapping,1,1,2,1,1,2,12,0.162975,0.169657,5147.725702,10,0.000218
n1453,laboratory,,laboratory,1,1,2,1,1,2,10,0.237272,0.256806,12171.370035,10,0.000213
n1454,practiced,,practiced,1,1,2,1,1,2,11,0.190703,0.201053,0,7,0.000149
n1455,subjecting,,subjecting,1,1,2,1,1,2,11,0.188242,0.197926,5025.195253,17,0.000154
n1456,systematic,,systematic,2,2,4,2,2,4,10,0.231811,0.250431,12847.625448,17,0.000374
n1457,bottomup,,bottomup,1,1,2,1,1,2,12,0.173925,0.182062,45.27381,17,0.000218
n1458,material,,material,9,8,17,11,11,22,10,0.246994,0.270809,57833.404061,12,0.001316
n1459,entities,,entities,3,2,5,3,3,6,11,0.18761,0.197514,5891.773275,16,0.000395
n1460,internal,,internal,1,1,2,2,2,4,10,0.221992,0.238271,3569.932025,16,0.000283
n1461,characteristic,,characteristic,1,1,2,1,1,2,10,0.221992,0.238271,800.575772,12,0.000153
n1462,hacking’s,,hacking’s,1,1,2,1,1,2,13,0.143152,0.147804,1153.829229,17,0.000156
n1463,psillos,,psillos,1,1,2,1,1,2,13,0.132106,0.135881,5129.044769,17,0.000185
n1464,tselfes,,tselfes,1,1,2,1,1,2,12,0.152151,0.157679,5141.044769,17,0.000216
n1465,kariotoglou2004,,kariotoglou2004,1,1,2,1,1,2,11,0.179367,0.188309,5153.044769,17,0.000242
n1466,establishing,,establishing,2,2,4,2,2,4,11,0.179857,0.188893,947.8728,21,0.000239
n1467,aims,,aims,2,2,4,2,2,4,11,0.195374,0.206407,3008.418799,16,0.000246
n1468,enabling,,enabling,1,1,2,1,1,2,11,0.1911,0.201894,159.048952,21,0.000164
n1469,peters2006,,peters2006,1,1,2,1,1,2,12,0.173092,0.180947,305.657823,21,0.000156
n1470,thought,,thought,4,3,7,4,4,8,11,0.209257,0.223432,11162.589332,21,0.00051
n1471,improve,,improve,1,1,2,2,2,4,10,0.221973,0.238251,217.474232,3,0.000247
n1472,hogan2000,,hogan2000,1,1,2,2,2,4,11,0.193475,0.203815,2951.857927,18,0.00024
n1473,hoganmaglienti2001,,hoganmaglienti2001,1,2,3,2,2,4,10,0.239798,0.260042,2963.857927,18,0.000263
n1474,deboo2000,,deboo2000,1,1,2,1,1,2,12,0.181241,0.191086,183.97381,9,0.000172
n1475,lind1999,,lind1999,4,4,8,4,4,8,11,0.221284,0.239936,17659.384208,9,0.000581
n1476,novak1977,,novak1977,1,1,2,1,1,2,13,0.14308,0.147613,2600.801732,9,0.000182
n1477,major,,major,1,1,2,1,1,2,12,0.166905,0.173896,2612.801732,9,0.000214
n1478,overwhelmingly,,overwhelmingly,2,2,4,2,2,4,11,0.209547,0.223153,3297.440511,2,0.000252
n1479,nses,,nses,4,4,8,4,4,8,10,0.237624,0.257929,16557.135349,18,0.000551
n1480,american,,american,1,1,2,1,1,2,11,0.193621,0.204228,23.111111,18,0.000176
n1481,council1996,,council1996,1,1,2,1,1,2,12,0.175939,0.183954,2493.86186,9,0.000159
n1482,guidelines,,guidelines,1,1,2,1,1,2,12,0.172569,0.180521,2135.950431,9,0.000203
n1483,bredekampcopple1997,,bredekampcopple1997,1,1,2,1,1,2,10,0.224652,0.241866,0,21,0.000152
n1484,grade,,grade,1,1,2,1,1,2,11,0.180438,0.189719,1741.596279,18,0.000152
n1485,act,,act,4,3,7,4,4,8,11,0.200016,0.213245,9588.948939,13,0.000553
n1486,associated,,associated,3,2,5,3,3,6,10,0.222088,0.23866,7243.029026,16,0.000377
n1487,techniques,,techniques,2,2,4,2,2,4,12,0.17795,0.186988,533.64582,0,0.000241
n1488,critically,,critically,1,1,2,1,1,2,12,0.150581,0.155885,2872.292385,12,0.000146
n1489,logically,,logically,1,1,2,1,1,2,11,0.177213,0.185722,2884.292385,12,0.000183
n1490,relationships,,relationships,2,3,5,3,3,6,10,0.215292,0.231024,7899.778353,12,0.000435
n1491,arguments,,arguments,1,1,2,1,1,2,12,0.170134,0.177698,2555,0,0.000151
n1492,coordination,,coordination,1,1,2,1,1,2,11,0.204948,0.218317,2567,0,0.000187
n1493,relies,,relies,1,1,2,1,1,2,11,0.204589,0.217008,454.543548,16,0.000146
n1494,‘tend,,‘tend,1,1,2,1,1,2,12,0.154262,0.159824,2644.743542,13,0.000162
n1495,mind,,mind,1,1,2,1,1,2,11,0.182335,0.191336,2656.743542,13,0.000197
n1496,speak,,speak,2,2,4,2,2,4,10,0.222897,0.239666,7088.288785,13,0.000314
n1497,analytical,,analytical,1,1,2,1,1,2,11,0.182919,0.191822,311.251775,16,0.000146
n1498,connects,,connects,1,1,2,1,1,2,11,0.204932,0.218298,590.820303,0,0.000146
n1499,theory’,,theory’,1,1,2,1,1,2,11,0.181625,0.19061,354.131457,0,0.000154
n1500,emphasis,,emphasis,3,3,6,3,3,6,10,0.221857,0.238821,11477.822164,0,0.000369
n1501,added,,added,2,2,4,2,2,4,12,0.167111,0.174473,7110.919252,0,0.000306
n1502,eshachfried2005p327,,eshachfried2005p327,1,1,2,1,1,2,11,0.190208,0.200219,2560.401236,0,0.000189
n1503,learner’s,,learner’s,2,2,4,2,2,4,11,0.211654,0.226152,3695.843949,16,0.000291
n1504,harlen1996,,harlen1996,1,1,2,1,1,2,12,0.161094,0.167235,3504.919444,11,0.00017
n1505,lind,,lind,1,1,2,1,1,2,11,0.191957,0.202156,3516.919444,11,0.000203
n1506,argues,,argues,2,2,4,2,2,4,10,0.237448,0.257172,12817,18,0.000393
n1507,preprimarylevel,,preprimarylevel,1,1,2,1,1,2,10,0.237338,0.256848,0,18,0.000226
n1508,‘…seen,,‘…seen,1,1,2,1,1,2,10,0.186398,0.1959,106.272357,5,0.000154
n1509,understand…’,,understand…’,1,1,2,1,1,2,12,0.167986,0.17509,100.141986,23,0.000149
n1510,aim,,aim,1,1,2,1,1,2,11,0.182231,0.191123,704.237567,16,0.000153
n1511,relating,,relating,1,1,2,1,1,2,11,0.217701,0.231836,1004.967438,11,0.00015
n1512,previously,,previously,1,1,2,1,1,2,11,0.192014,0.20244,231.974897,7,0.000152
n1513,1996,,1996,1,1,2,1,1,2,11,0.220259,0.237763,361.053072,9,0.000176
n1514,advance,,advance,2,2,4,2,2,4,11,0.21748,0.232514,2072.907776,7,0.000269
n1515,whose,,whose,1,1,2,1,1,2,11,0.196165,0.207344,453.233494,22,0.000164
n1516,fleer1993,,fleer1993,1,1,2,1,1,2,11,0.188782,0.198829,290.07616,15,0.000146
n1517,depth,,depth,2,2,4,2,2,4,12,0.165688,0.172653,2946.85026,1,0.000271
n1518,complexity,,complexity,2,2,4,2,2,4,11,0.191,0.201352,4584.941591,1,0.000314
n1519,bredekampcople,,bredekampcople,1,1,2,1,1,2,14,0.13314,0.137221,5109,9,0.000168
n1520,1997,,1997,1,1,2,1,1,2,13,0.153524,0.159549,5121,9,0.000201
n1521,eshachfried2005,,eshachfried2005,1,1,2,1,1,2,12,0.181279,0.191115,5133,9,0.00023
n1522,discussed,,discussed,1,1,2,1,1,2,12,0.154243,0.159815,2763.762553,9,0.000166
n1523,earlier,,earlier,1,1,2,1,1,2,11,0.182322,0.191406,2775.762553,9,0.0002
n1524,hacking1992,,hacking1992,1,1,2,1,1,2,12,0.158021,0.163984,413.310428,16,0.000165
n1525,psillosetal2004,,psillosetal2004,1,0,1,1,0,1,0,0,0,0,16,0.000146
n1526,occurs,,occurs,2,2,4,2,2,4,11,0.21141,0.225582,2624.558981,23,0.000268
n1527,structure,,structure,4,5,9,5,5,10,11,0.198439,0.211148,15679.755892,5,0.000617
n1528,bridge,,bridge,2,2,4,2,2,4,11,0.20286,0.21429,1476.017097,1,0.000257
n1529,current,,current,3,3,6,3,3,6,10,0.253105,0.2747,9903.176717,1,0.000386
n1530,rogoff1990,,rogoff1990,1,1,2,1,1,2,12,0.180553,0.189965,2555,9,0.000144
n1531,vygotsky1978,,vygotsky1978,1,1,2,1,1,2,11,0.220259,0.237763,2567,9,0.000181
n1532,ermeling2010,,ermeling2010,2,2,4,2,2,4,10,0.209018,0.222666,684.353954,6,0.000238
n1533,inquisitiveness,,inquisitiveness,1,1,2,1,1,2,11,0.178197,0.186998,403.283608,5,0.000158
n1534,edwardsetal2011,,edwardsetal2011,1,1,2,1,1,2,11,0.220259,0.237763,793.550109,12,0.000157
n1535,impact,,impact,2,2,4,2,2,4,11,0.215382,0.230296,4684.476875,4,0.000316
n1536,questioning,,questioning,8,8,16,8,8,16,10,0.20965,0.224892,18707.047248,16,0.000917
n1537,let,,let,2,2,4,2,2,4,10,0.225204,0.242803,6961.840959,2,0.000349
n1538,giving,,giving,2,2,4,2,2,4,10,0.225441,0.243482,1951.49054,21,0.000266
n1539,seven,,seven,1,1,2,1,1,2,11,0.185241,0.194999,118.598964,3,0.000159
n1540,experimenting,,experimenting,1,1,2,1,1,2,12,0.173925,0.182062,282.757353,17,0.000162
n1541,conclusion,,conclusion,2,2,4,2,2,4,11,0.208594,0.221785,5935.928634,0,0.000309
n1542,grouped,,grouped,1,1,2,1,1,2,10,0.238595,0.258577,2162.984474,3,0.000157
n1543,four,,four,4,4,8,4,4,8,11,0.208543,0.22246,11004.935163,12,0.00055
n1544,reflect,,reflect,3,3,6,4,4,8,11,0.202412,0.215394,4184.775576,12,0.000524
n1545,plan,,plan,4,3,7,4,4,8,11,0.196751,0.208732,7929.021711,3,0.000558
n1546,predict,,predict,2,3,5,3,3,6,11,0.192057,0.203035,6727.672544,3,0.000396
n1547,3,,3,6,6,12,6,6,12,10,0.233073,0.252609,14837.625744,0,0.000679
n1548,4,,4,3,3,6,3,3,6,11,0.200672,0.212782,1627.468736,16,0.000372
n1549,conjunction,,conjunction,1,1,2,1,1,2,14,0.133023,0.136722,5109,21,0.000145
n1550,multiday,,multiday,1,1,2,1,1,2,13,0.153368,0.158792,5121,21,0.000182
n1551,projects,,projects,1,1,2,1,1,2,12,0.181062,0.189858,5133,21,0.000214
n1552,higher,,higher,1,1,2,1,1,2,11,0.187172,0.19663,160.2455,3,0.000143
n1553,predicting,,predicting,4,4,8,4,4,8,11,0.189436,0.200055,15162.59108,16,0.000486
n1554,lens,,lens,1,1,2,1,1,2,10,0.231664,0.250054,0,5,0.00015
n1555,carries,,carries,1,1,2,1,1,2,11,0.193403,0.203923,9117.085789,18,0.000146
n1556,beyond,,beyond,5,5,10,5,5,10,10,0.239709,0.260406,26737.319881,18,0.000681
n1557,“authentic,,“authentic,1,1,2,1,1,2,10,0.216471,0.232143,3918.493594,12,0.00015
n1558,experiences”,,experiences”,1,1,2,1,1,2,12,0.161195,0.167433,2670.170625,11,0.000163
n1559,p21,,p21,1,1,2,1,1,2,11,0.192086,0.202487,2682.170625,11,0.000198
n1560,assert,,assert,1,1,2,1,1,2,11,0.209993,0.223431,62.799475,0,0.000176
n1561,objects,,objects,12,12,24,12,12,24,10,0.232167,0.252805,69436.469196,2,0.001484
n1562,identify,,identify,3,3,6,3,3,6,11,0.190618,0.201986,4775.662329,16,0.000354
n1563,assumptions,,assumptions,2,1,3,2,2,4,10,0.209838,0.222387,3322.573091,16,0.000296
n1564,consider,,consider,3,3,6,3,3,6,11,0.201776,0.213605,14981.48614,11,0.000458
n1565,combining,,combining,1,1,2,1,1,2,10,0.237229,0.256709,0,18,0.000152
n1566,p2,,p2,1,1,2,1,1,2,11,0.22024,0.237743,0,9,0.000144
n1567,drawn,,drawn,1,1,2,1,1,2,12,0.166332,0.173085,1749.591372,5,0.000166
n1568,eickreed2002,,eickreed2002,1,1,2,1,1,2,10,0.238595,0.258577,147.732973,16,0.000153
n1569,orientation,,orientation,2,2,4,2,2,4,11,0.197326,0.209131,528.68324,16,0.000281
n1570,bianchinicolburn2000,,bianchinicolburn2000,1,1,2,1,1,2,13,0.146953,0.151892,3027.778491,16,0.000152
n1571,lambert2007,,lambert2007,1,1,2,1,1,2,12,0.172222,0.179988,3039.778491,16,0.000188
n1572,describes,,describes,2,2,4,2,2,4,11,0.207986,0.221879,7725.226433,16,0.000343
n1573,“as,,“as,2,2,4,2,2,4,10,0.23202,0.250801,5023.27989,3,0.000249
n1574,inferring,,inferring,1,1,2,1,1,2,12,0.172083,0.180311,307.432044,3,0.00017
n1575,judging,,judging,1,1,2,1,1,2,11,0.167854,0.174923,120.992087,16,0.000163
n1576,generalizing,,generalizing,1,1,2,1,1,2,12,0.159315,0.165513,0,16,0.000162
n1577,decisionmaking”,,decisionmaking”,1,1,2,1,1,2,11,0.181715,0.190527,2822.601443,16,0.000162
n1578,p389,,p389,1,1,2,1,1,2,10,0.221992,0.238271,2834.601443,16,0.000197
n1579,interpret,,interpret,2,2,4,2,2,4,11,0.211323,0.225905,848.173183,0,0.000258
n1580,nrc1996,,nrc1996,3,3,6,3,3,6,11,0.197751,0.210145,5362.839638,1,0.00036
n1581,bodzinbeerer2003,,bodzinbeerer2003,1,1,2,1,1,2,11,0.201443,0.213688,311.420683,1,0.000161
n1582,rubric,,rubric,1,1,2,1,1,2,11,0.166483,0.17386,2555,21,0.00015
n1583,stir,,stir,2,2,4,2,2,4,10,0.199673,0.212682,2567,21,0.000187
n1584,rate,,rate,1,1,2,1,1,2,11,0.213024,0.227105,420.645206,21,0.000154
n1585,six,,six,2,2,4,2,2,4,11,0.194134,0.205238,1173.072669,16,0.000273
n1586,categories,,categories,3,3,6,3,3,6,11,0.197721,0.209089,3045.501479,21,0.00027
n1587,explained,,explained,1,1,2,1,1,2,12,0.171189,0.178848,80.916967,21,0.000174
n1588,prospective,,prospective,1,1,2,1,1,2,11,0.19958,0.212736,323.461996,7,0.000153
n1589,year,,year,1,1,2,1,1,2,10,0.208543,0.221762,838.589411,7,0.000167
n1590,windschitl2003,,windschitl2003,1,1,2,1,1,2,12,0.172222,0.179988,2105.447942,16,0.000146
n1591,confirmation,,confirmation,2,2,4,2,2,4,10,0.218889,0.234933,4615.475038,7,0.000261
n1592,“cookbook,,“cookbook,1,1,2,1,1,2,12,0.167712,0.174754,2571.388555,21,0.000153
n1593,labs”,,labs”,1,1,2,1,1,2,11,0.201443,0.213688,2583.388555,21,0.000189
n1594,verify,,verify,1,1,2,1,1,2,11,0.193417,0.203912,1323.462096,20,0.000154
n1595,discover,,discover,3,3,6,3,3,6,12,0.17577,0.184632,7670.917387,12,0.000381
n1596,unknown,,unknown,1,1,2,1,1,2,12,0.173268,0.180884,323.651209,12,0.000167
n1597,answer,,answer,4,4,8,4,4,8,11,0.209513,0.223245,10293.282242,12,0.000513
n1598,independent,,independent,1,1,2,1,1,2,11,0.182102,0.191221,129.343566,13,0.000155
n1599,p114,,p114,1,1,2,1,1,2,11,0.220259,0.237763,2353.149794,13,0.00016
n1600,understood,,understood,1,1,2,1,1,2,11,0.197614,0.208821,75.43507,5,0.000146
n1601,small,,small,4,4,8,4,4,8,11,0.206348,0.219497,12874.806117,16,0.000484
n1602,sensemaking,,sensemaking,1,1,2,1,1,2,11,0.193083,0.204225,153.196458,16,0.000167
n1603,discussions,,discussions,4,4,8,4,4,8,10,0.239173,0.261313,11246.042165,21,0.000578
n1604,hand,,hand,4,4,8,4,4,8,10,0.212284,0.22615,15192.957111,1,0.000559
n1605,promote,,promote,1,1,2,1,1,2,11,0.194885,0.205272,170.931814,8,0.00015
n1606,structuring,,structuring,3,3,6,3,3,6,11,0.206215,0.219459,15667.632119,8,0.000496
n1607,standard,,standard,1,1,2,1,1,2,10,0.237272,0.256806,774.548783,18,0.000174
n1608,matching,,matching,1,1,2,1,1,2,11,0.182724,0.191523,1640.946349,19,0.00017
n1609,along,,along,1,1,2,1,1,2,11,0.199255,0.21102,102.123421,5,0.000146
n1610,trundlesackes2012,,trundlesackes2012,1,1,2,1,1,2,11,0.201538,0.213716,2381.057848,18,0.000168
n1611,regard,,regard,6,6,12,6,6,12,10,0.251839,0.274585,13257.45555,16,0.000657
n1612,accompanying,,accompanying,1,1,2,1,1,2,11,0.204442,0.216708,83.514424,5,0.000156
n1613,appleton2008,,appleton2008,2,2,4,2,2,4,11,0.19167,0.202221,2180.023619,8,0.000241
n1614,progression,,progression,2,2,4,2,2,4,11,0.19648,0.208454,2616.406938,3,0.000248
n1615,specified,,specified,1,1,2,1,1,2,11,0.220259,0.237763,1057.593129,6,0.000152
n1616,unproductive,,unproductive,1,1,2,1,1,2,12,0.176253,0.184586,422.586106,16,0.000148
n1617,low,,low,1,1,2,1,1,2,15,0.113287,0.115712,7664.702381,1,0.000157
n1618,selfregulation,,selfregulation,1,1,2,1,1,2,14,0.12771,0.130915,7676.702381,1,0.000192
n1619,capacities,,capacities,1,1,2,1,1,2,13,0.146341,0.150889,7688.702381,1,0.000222
n1620,persistent,,persistent,1,1,2,1,1,2,12,0.171337,0.1784,7700.702381,1,0.000248
n1621,misconceptions,,misconceptions,2,2,4,2,2,4,11,0.20663,0.219063,14091.53545,1,0.00039
n1622,traditional,,traditional,3,3,6,3,3,6,11,0.192909,0.203629,6123.046095,11,0.000453
n1623,fail,,fail,1,1,2,1,1,2,12,0.169148,0.176462,698.421118,6,0.000152
n1624,longterm,,longterm,1,1,2,1,1,2,11,0.194325,0.205401,351.966062,11,0.000163
n1625,restructuring,,restructuring,1,4,5,4,4,8,11,0.210924,0.225281,3420.961904,1,0.000464
n1626,duittreagust2003,,duittreagust2003,1,1,2,1,1,2,12,0.185737,0.195978,497.66436,9,0.000154
n1627,holliday2006,,holliday2006,2,2,4,2,2,4,11,0.228023,0.247636,8726.837094,9,0.000296
n1628,propose,,propose,1,1,2,1,1,2,11,0.182724,0.191523,65.357242,19,0.000164
n1629,foci,,foci,1,1,2,1,1,2,12,0.185108,0.194555,1322.354341,19,0.00017
n1630,intended,,intended,3,3,6,3,3,6,11,0.21155,0.226155,3665.355081,5,0.000376
n1631,features,,features,4,5,9,6,6,12,10,0.211358,0.22573,31614.041486,14,0.000715
n1632,targeted,,targeted,4,3,7,4,4,8,11,0.215147,0.230215,14931.634019,19,0.000451
n1633,b,,b,3,3,6,3,3,6,11,0.185469,0.195793,9165.5624,18,0.000375
n1634,embedding,,embedding,1,1,2,1,1,2,10,0.221973,0.238251,3290.758418,18,0.000165
n1635,threestep,,threestep,3,2,5,3,3,6,10,0.222511,0.238811,4201.688968,5,0.00039
n1636,increasingly,,increasingly,1,1,2,1,1,2,12,0.169751,0.17728,685.986135,15,0.000152
n1637,responsibility,,responsibility,1,1,2,1,1,2,10,0.231685,0.250087,4890.333136,15,0.000156
n1638,scaffolds,,scaffolds,2,1,3,2,2,4,11,0.180362,0.189357,1468.667325,14,0.000261
n1639,instructionally,,instructionally,1,1,2,1,1,2,12,0.151549,0.156831,2575.337729,5,0.00016
n1640,sensitive,,sensitive,1,1,2,1,1,2,11,0.178569,0.187121,2587.337729,5,0.000195
n1641,ensure,,ensure,2,2,4,2,2,4,11,0.217978,0.23283,5694.900121,5,0.00033
n1642,objects’,,objects’,3,2,5,3,3,6,12,0.173127,0.181375,5600.353173,12,0.000343
n1643,floating,,floating,4,2,6,5,5,10,11,0.195866,0.207955,10333.905916,12,0.000612
n1644,sinking,,sinking,1,4,5,4,4,8,10,0.229655,0.249727,6285.445664,12,0.000475
n1645,usually,,usually,1,1,2,1,1,2,12,0.149398,0.15426,24.196537,1,0.00016
n1646,salient,,salient,1,1,2,1,1,2,11,0.17454,0.182366,1634.137701,5,0.000162
n1647,shape,,shape,2,1,3,2,2,4,14,0.126105,0.129507,15588.090378,14,0.0003
n1648,weight,,weight,1,1,2,2,2,4,13,0.144253,0.149126,15600.090378,14,0.000314
n1649,size,,size,1,2,3,2,2,4,12,0.168504,0.176223,15612.090378,14,0.000325
n1650,targeting,,targeting,1,1,2,1,1,2,11,0.194325,0.205401,922.970688,5,0.000172
n1651,properties,,properties,3,3,6,3,3,6,11,0.182516,0.192502,9881.593952,2,0.000378
n1652,supported,,supported,3,3,6,3,3,6,11,0.178942,0.187466,7900.966107,21,0.000323
n1653,similarities,,similarities,2,4,6,4,4,8,11,0.204736,0.218586,7638.544006,12,0.000498
n1654,samematerial,,samematerial,1,1,2,1,1,2,11,0.188491,0.198802,0,2,0.000177
n1655,verbally,,verbally,1,1,2,1,1,2,13,0.144643,0.14932,2593.122124,12,0.000164
n1656,nonverbally,,nonverbally,1,1,2,1,1,2,12,0.169047,0.176336,2605.122124,12,0.000198
n1657,function,,function,4,4,8,4,4,8,10,0.239552,0.260242,15003.082327,16,0.000531
n1658,‘invitation,,‘invitation,1,1,2,1,1,2,13,0.153368,0.158792,2563.86408,16,0.000172
n1659,comparison’,,comparison’,1,1,2,1,1,2,12,0.181062,0.189858,2575.86408,16,0.000205
n1660,namygentner2002,,namygentner2002,1,1,2,1,1,2,11,0.202716,0.215139,76.670855,18,0.000151
n1661,stimulate,,stimulate,2,2,4,2,2,4,10,0.22556,0.243235,4188.420027,21,0.000281
n1662,educated,,educated,1,1,2,1,1,2,12,0.168063,0.175288,1087.505493,2,0.000152
n1663,expectations,,expectations,3,3,6,3,3,6,11,0.201934,0.214628,21354.977605,2,0.000515
n1664,justify,,justify,1,2,3,2,2,4,11,0.187568,0.197485,1070.058293,2,0.000251
n1665,argument,,argument,2,2,4,3,3,6,10,0.20708,0.220928,1638.730829,0,0.000372
n1666,bybee2006,,bybee2006,1,1,2,1,1,2,17,0.08367,0.085135,15315,19,0.000151
n1667,molleretal2012,,molleretal2012,1,1,2,1,1,2,16,0.091274,0.092956,15327,19,0.000188
n1668,wisersmith2008,,wisersmith2008,1,1,2,1,1,2,15,0.100399,0.102408,15339,19,0.000218
n1669,pointed,,pointed,1,1,2,1,1,2,14,0.11155,0.114069,15351,19,0.000244
n1670,‘using,,‘using,1,1,2,1,1,2,13,0.125489,0.128837,15363,19,0.000267
n1671,“plastic”,,“plastic”,1,1,2,1,1,2,12,0.143408,0.148192,15375,19,0.000286
n1672,adjective,,adjective,1,1,2,1,1,2,11,0.167296,0.174794,15387,19,0.000302
n1673,guides,,guides,2,2,4,2,2,4,11,0.200735,0.214121,20837.37517,19,0.000413
n1674,generalization,,generalization,1,1,2,1,1,2,11,0.176349,0.184781,754.848927,19,0.000235
n1675,kinds,,kinds,3,3,6,3,3,6,12,0.164215,0.171705,13157.241343,2,0.000458
n1676,plastic,,plastic,1,1,2,1,1,2,11,0.188463,0.198769,3610.817322,2,0.000189
n1677,‘plastic’,,‘plastic’,1,1,2,1,1,2,15,0.10988,0.112219,10214,3,0.000175
n1678,shininess,,shininess,1,1,2,1,1,2,14,0.12339,0.126454,10226,3,0.000208
n1679,lightness,,lightness,1,1,2,1,1,2,13,0.140689,0.144992,10238,3,0.000236
n1680,flexibility’,,flexibility’,1,1,2,1,1,2,12,0.163629,0.170234,10250,3,0.000259
n1681,p209,,p209,1,1,2,1,1,2,11,0.195508,0.206961,10262,3,0.000279
n1682,grammatical,,grammatical,1,1,2,1,1,2,11,0.206066,0.218847,945.582846,1,0.000151
n1683,‘this,,‘this,3,3,6,3,3,6,12,0.173279,0.182193,8256.991959,15,0.000421
n1684,plastic’,,plastic’,2,2,4,2,2,4,13,0.147714,0.153288,2975.987175,15,0.000271
n1685,opposed,,opposed,1,1,2,1,1,2,13,0.147705,0.153094,0,15,0.000174
n1686,cup’,,cup’,1,1,2,1,1,2,12,0.17837,0.186469,1429.359905,23,0.000178
n1687,draws,,draws,2,2,4,2,2,4,11,0.216984,0.231777,13021.557703,23,0.000315
n1688,attention,,attention,1,1,2,1,1,2,11,0.198133,0.209793,482.464247,5,0.000158
n1689,detect,,detect,2,2,4,2,2,4,12,0.176108,0.184775,9205.146465,12,0.000257
n1690,appearance,,appearance,1,1,2,1,1,2,12,0.166569,0.173307,78.019426,12,0.000165
n1691,concerning,,concerning,2,2,4,2,2,4,10,0.238484,0.258152,5220.858635,12,0.000258
n1692,solid,,solid,1,1,2,1,1,2,11,0.188477,0.198789,855.484089,11,0.000189
n1693,differ,,differ,1,1,2,1,1,2,15,0.112022,0.114579,3479.574506,14,0.000164
n1694,consist,,consist,2,2,4,2,2,4,11,0.198424,0.210324,25744.994244,14,0.000424
n1695,problembased,,problembased,3,2,5,3,3,6,10,0.233795,0.252929,9420.666934,15,0.000369
n1696,putting,,putting,1,1,2,1,1,2,10,0.221992,0.238271,0,15,0.00017
n1697,scaffold,,scaffold,1,1,2,1,1,2,11,0.19431,0.205381,444.991586,1,0.000148
n1698,dewey1910hmelosilver2006authentic,,dewey1910hmelosilver2006authentic,1,1,2,1,1,2,11,0.195911,0.206733,181.590664,12,0.000151
n1699,personally,,personally,1,1,2,1,1,2,11,0.202844,0.214825,420.597212,3,0.000158
n1700,pintrich,,pintrich,1,1,2,1,1,2,12,0.154615,0.160027,2561,3,0.000147
n1701,marxboyle1993,,marxboyle1993,1,1,2,1,1,2,11,0.182828,0.191623,2573,3,0.000184
n1702,multiperspectives’,,multiperspectives’,1,1,2,1,1,2,12,0.171945,0.179396,150.8449,4,0.000165
n1703,paths,,paths,1,3,4,3,3,6,10,0.209274,0.223091,4350.399458,11,0.000402
n1704,mayerwittrock2006,,mayerwittrock2006,1,1,2,1,1,2,11,0.202732,0.215152,137.760899,18,0.000165
n1705,linneylon2006,,linneylon2006,1,1,2,1,1,2,11,0.202844,0.214825,184.419469,3,0.000157
n1706,contextualized,,contextualized,1,1,2,1,1,2,11,0.195896,0.206714,245.224512,12,0.000153
n1707,float,,float,1,1,2,1,1,2,13,0.150952,0.156357,1880.110842,15,0.00017
n1708,sink,,sink,1,1,2,1,1,2,12,0.164563,0.172271,359.431988,9,0.000152
n1709,avoid,,avoid,1,1,2,1,1,2,11,0.184496,0.194949,650.184233,6,0.000157
n1710,stepbystep,,stepbystep,1,1,2,1,1,2,11,0.178581,0.187134,198.453447,5,0.000169
n1711,initially,,initially,1,1,2,1,1,2,13,0.147748,0.152817,2587.923431,23,0.000157
n1712,unable,,unable,1,1,2,1,1,2,12,0.173303,0.181325,2599.923431,23,0.000192
n1713,broader,,broader,3,3,6,3,3,6,10,0.228246,0.245876,9405.19526,20,0.000386
n1714,fruitful,,fruitful,1,1,2,1,1,2,11,0.18356,0.192728,2605.35067,15,0.00017
n1715,leave,,leave,1,1,2,1,1,2,10,0.224731,0.241996,2617.35067,15,0.000204
n1716,organizing,,organizing,2,2,4,2,2,4,10,0.233158,0.251852,3301.502498,0,0.000259
n1717,atkinkarplus1962,,atkinkarplus1962,1,1,2,1,1,2,13,0.151908,0.156975,2582.286417,5,0.000164
n1718,schiefelepekrun1996,,schiefelepekrun1996,1,1,2,1,1,2,12,0.179042,0.187141,2594.286417,5,0.000198
n1719,patterns,,patterns,3,3,6,3,3,6,11,0.20572,0.219601,9246.201638,0,0.000372
n1720,indeed,,indeed,1,1,2,1,1,2,11,0.166505,0.173958,140.053082,21,0.000164
n1721,stimulated,,stimulated,2,2,4,2,2,4,10,0.199689,0.212923,7770.658549,21,0.000285
n1722,carried,,carried,1,1,2,1,1,2,12,0.173244,0.180731,294.579462,21,0.000145
n1723,selfreliant,,selfreliant,1,1,2,1,1,2,11,0.19025,0.200969,627.223582,23,0.000152
n1724,hiemstra2000,,hiemstra2000,1,1,2,1,1,2,11,0.182076,0.190861,150.686487,23,0.000157
n1725,summarizes,,summarizes,1,1,2,1,1,2,11,0.180122,0.18884,656.705404,19,0.000164
n1726,bscs,,bscs,1,1,2,1,1,2,11,0.183744,0.19292,0,7,0.000162
n1727,elaboration,,elaboration,2,1,3,3,3,6,12,0.173784,0.182097,391.818523,19,0.000345
n1728,considers,,considers,1,1,2,1,1,2,10,0.231706,0.250106,1415.176853,5,0.000155
n1729,preparation,,preparation,1,1,2,1,1,2,11,0.191128,0.201979,819.351678,7,0.000152
n1730,motivation,,motivation,3,3,6,3,3,6,11,0.200406,0.212842,3013.680122,14,0.00037
n1731,groupconcerning,,groupconcerning,1,1,2,1,1,2,11,0.191114,0.201907,113.203283,8,0.00016
n1732,introduction,,introduction,1,1,2,1,1,2,12,0.147714,0.153084,128.196081,15,0.00016
n1733,domainspecific,,domainspecific,1,1,2,1,1,2,10,0.218182,0.233673,509.058179,15,0.000161
n1734,capabilities,,capabilities,2,2,4,2,2,4,11,0.178581,0.188338,3746.223072,5,0.00025
n1735,coneziofrench2002,,coneziofrench2002,1,1,2,1,1,2,12,0.172592,0.180758,765.425595,18,0.000152
n1736,executive,,executive,1,1,2,1,1,2,12,0.173537,0.181278,104.620483,15,0.000163
n1737,garon,,garon,1,1,2,1,1,2,13,0.138414,0.142675,5110.15,15,0.000182
n1738,brysonsmith2008,,brysonsmith2008,1,1,2,1,1,2,12,0.16058,0.167017,5122.15,15,0.000213
n1739,operation,,operation,1,1,2,1,1,2,11,0.191199,0.20206,5134.15,15,0.00024
n1740,adaptively,,adaptively,1,1,2,1,1,2,11,0.208984,0.222314,0,5,0.000157
n1741,elaborating,,elaborating,1,1,2,1,1,2,12,0.175506,0.184054,198.087897,2,0.000156
n1742,providing,,providing,4,4,8,4,4,8,11,0.214447,0.229646,10328.529675,5,0.00046
n1743,fading,,fading,1,1,2,1,1,2,13,0.135651,0.139703,2634.311159,11,0.000157
n1744,aids,,aids,1,1,2,1,1,2,12,0.156891,0.162962,2646.311159,11,0.000192
n1745,carrying,,carrying,2,2,4,2,2,4,11,0.18602,0.196216,6656.440707,11,0.000326
n1746,lepperetal1997,,lepperetal1997,1,1,2,1,1,2,11,0.186832,0.196631,173.034936,7,0.000178
n1747,examine,,examine,1,1,2,1,1,2,13,0.148054,0.152898,2567.126818,11,0.000149
n1748,others’,,others’,1,1,2,1,1,2,12,0.173725,0.18136,2579.126818,11,0.000186
n1749,detecting,,detecting,1,1,2,1,1,2,11,0.187651,0.197109,66.223955,11,0.000173
n1750,kuhn2009,,kuhn2009,1,1,2,1,1,2,11,0.199596,0.212756,682.851134,7,0.000146
n1751,frame,,frame,1,1,2,1,1,2,12,0.165507,0.172303,183.87908,2,0.000164
n1752,mistakes,,mistakes,2,2,4,2,2,4,11,0.198271,0.210001,7965.451684,2,0.00029
n1753,kloosvanorden2005,,kloosvanorden2005,1,0,1,1,0,1,0,0,0,0,13,0.000151
n1754,experiential,,experiential,5,2,7,6,7,13,10,0.222723,0.238913,15330.181729,18,0.000784
n1755,oversimplified,,oversimplified,1,1,2,1,1,2,10,0.231664,0.250054,1461.062267,6,0.000152
n1756,breunig2008,,breunig2008,1,1,2,1,1,2,13,0.137011,0.141334,4367.449,6,0.000146
n1757,roberts2011,,roberts2011,1,1,2,1,1,2,12,0.158714,0.165254,4379.449,6,0.000183
n1758,regarded,,regarded,1,1,2,1,1,2,11,0.184007,0.193833,365.531946,6,0.000152
n1759,founders,,founders,1,1,2,1,1,2,11,0.182205,0.190919,155.927139,9,0.000159
n1760,believed,,believed,1,1,2,1,1,2,13,0.145126,0.149892,46.506484,20,0.000181
n1761,isolation,,isolation,1,1,2,1,1,2,11,0.16974,0.177076,46.38199,16,0.000166
n1762,emphasized,,emphasized,2,2,4,2,2,4,10,0.204377,0.217334,4033.98337,16,0.000292
n1763,local,,local,1,1,2,1,1,2,11,0.175099,0.183346,110.254015,22,0.000159
n1764,outofclassroom,,outofclassroom,1,1,2,1,1,2,11,0.22024,0.237743,1215.497362,14,0.00016
n1765,embraces,,embraces,1,1,2,1,1,2,11,0.188824,0.198827,101.179328,18,0.000142
n1766,transdisciplinary,,transdisciplinary,4,4,8,5,5,10,10,0.232714,0.252183,13028.061758,18,0.000587
n1767,recreate,,recreate,1,1,2,1,1,2,10,0.218145,0.23364,1208.422821,21,0.000164
n1768,educative,,educative,1,1,2,1,1,2,10,0.221227,0.236953,1210.122018,16,0.00016
n1769,extends,,extends,1,1,2,1,1,2,11,0.193403,0.203923,1344.316136,18,0.000142
n1770,commonplace,,commonplace,1,1,2,1,1,2,12,0.15844,0.164269,5109,18,0.000175
n1771,reference,,reference,1,1,2,1,1,2,11,0.188201,0.197809,5121,18,0.000207
n1772,bhands,,bhands,1,1,2,1,1,2,10,0.231727,0.250119,5133,18,0.000235
n1773,trips,,trips,1,1,2,1,1,2,12,0.157295,0.162981,2561.277598,23,0.00016
n1774,internships,,internships,1,1,2,1,1,2,11,0.186574,0.19597,2573.277598,23,0.000195
n1775,projectbased,,projectbased,1,1,2,1,1,2,10,0.231644,0.249989,0,5,0.000146
n1776,communityacademic,,communityacademic,1,1,2,1,1,2,12,0.15894,0.1649,7019.80478,5,0.000146
n1777,breunig2017,,breunig2017,1,1,2,1,1,2,11,0.220259,0.237763,2271.126734,18,0.000153
n1778,classroombased,,classroombased,1,1,2,2,2,4,11,0.174658,0.181983,71.040444,18,0.000259
n1779,studentcentred,,studentcentred,1,1,2,2,2,4,11,0.182218,0.190932,52.30747,18,0.000271
n1780,relationship,,relationship,2,2,4,3,3,6,11,0.207834,0.221608,4092.762807,23,0.00037
n1781,individuals,,individuals,1,1,2,2,2,4,11,0.186208,0.195958,168.429929,23,0.000269
n1782,gordon2009,,gordon2009,1,1,2,2,2,4,11,0.187199,0.197097,1626.49421,5,0.000234
n1783,savery2006,,savery2006,3,2,5,5,4,9,10,0.230252,0.249128,7716.695601,5,0.000585
n1784,queries,,queries,1,1,2,2,2,4,11,0.199596,0.212756,510.298841,7,0.00029
n1785,serving,,serving,2,2,4,3,3,6,11,0.204573,0.217149,5724.179192,7,0.000348
n1786,provocateurs,,provocateurs,1,1,2,2,2,4,11,0.178706,0.187008,2570.891515,7,0.000256
n1787,moving,,moving,1,1,2,2,2,4,10,0.217517,0.232764,2582.891515,7,0.000276
n1788,forward,,forward,2,2,4,3,3,6,10,0.225085,0.242781,4137.67421,21,0.000372
n1789,ontarioministryofeducation2013,,ontarioministryofeducation2013,1,1,2,2,2,4,11,0.183533,0.192705,2606.661597,21,0.000252
n1790,viewing,,viewing,1,1,2,2,2,4,10,0.224711,0.241983,2618.661597,21,0.000273
n1791,knowledgepossessing,,knowledgepossessing,1,1,2,2,2,4,12,0.163359,0.169818,1892.837184,16,0.000245
n1792,capable,,capable,2,2,4,3,3,6,11,0.195196,0.206257,3923.535696,16,0.000371
n1793,fielding2012,,fielding2012,1,1,2,2,2,4,11,0.187199,0.197097,294.394395,5,0.000233
n1794,specificallyinvolves,,specificallyinvolves,1,1,2,1,1,2,13,0.134973,0.138805,5109,7,0.000146
n1795,openendedinvestigation,,openendedinvestigation,1,1,2,1,1,2,12,0.155977,0.161625,5121,7,0.000183
n1796,intostudents’,,intostudents’,1,1,2,1,1,2,11,0.184722,0.193931,5133,7,0.000215
n1797,typical,,typical,2,2,4,2,2,4,11,0.185255,0.19471,10110.12734,2,0.00036
n1798,studentcentered,,studentcentered,1,1,2,1,1,2,10,0.208273,0.220607,89.849639,5,0.000146
n1799,gathering,,gathering,1,1,2,1,1,2,11,0.192793,0.204055,307.095788,0,0.000156
n1800,breunig2013,,breunig2013,1,1,2,1,1,2,11,0.187213,0.197117,647.806996,5,0.000152
n1801,examining,,examining,1,2,3,2,2,4,11,0.18119,0.190735,1767.915357,2,0.000249
n1802,preschoolers’,,preschoolers’,3,3,6,3,3,6,10,0.217149,0.233384,17669.681002,2,0.000445
n1803,previous,,previous,3,2,5,4,4,8,11,0.187145,0.198443,6221.463025,2,0.00052
n1804,greifetal2006,,greifetal2006,1,1,2,1,1,2,12,0.166407,0.173665,0,2,0.000155
n1805,hold,,hold,1,1,2,1,1,2,10,0.193855,0.204605,321.395862,2,0.000155
n1806,categorizing,,categorizing,2,2,4,2,2,4,11,0.186114,0.19603,3371.167397,2,0.000263
n1807,novel,,novel,1,1,2,1,1,2,14,0.137026,0.141385,440.207522,2,0.000171
n1808,animals,,animals,3,3,6,3,3,6,13,0.158714,0.165587,10754.488271,2,0.000453
n1809,inanimate,,inanimate,1,1,2,1,1,2,12,0.178,0.18639,3799.365367,2,0.000187
n1810,artifacts,,artifacts,3,4,7,4,4,8,11,0.216435,0.232058,20886.210533,2,0.000599
n1811,informationseeking,,informationseeking,1,1,2,1,1,2,13,0.142746,0.147372,2555,2,0.000154
n1812,differences,,differences,1,1,2,1,1,2,12,0.16644,0.173694,2567,2,0.00019
n1813,appropriately,,appropriately,2,2,4,2,2,4,11,0.193972,0.204731,6619.36861,1,0.000257
n1814,plants,,plants,4,2,6,4,4,8,12,0.17779,0.18645,13332.122227,2,0.000632
n1815,mobile,,mobile,2,3,5,4,4,8,12,0.185858,0.196036,16745.330494,2,0.000568
n1816,arguably,,arguably,1,1,2,1,1,2,14,0.133743,0.13761,2611.531188,24,0.000145
n1817,targets,,targets,1,1,2,1,1,2,13,0.154327,0.160067,2623.531188,24,0.000182
n1818,awareness,,awareness,2,2,4,2,2,4,11,0.192518,0.20316,4040.226784,24,0.000303
n1819,living–nonliving,,living–nonliving,1,1,2,1,1,2,13,0.141107,0.145796,112.81103,2,0.000188
n1820,distinction,,distinction,2,2,4,2,2,4,11,0.169516,0.177444,8698.907389,2,0.000373
n1821,relying,,relying,1,1,2,1,1,2,11,0.178457,0.187197,1787.890621,2,0.000217
n1822,explicit,,explicit,1,1,2,1,1,2,13,0.126646,0.130046,2603.562543,2,0.000185
n1823,verbalization,,verbalization,1,1,2,1,1,2,12,0.144978,0.149903,2615.562543,2,0.000216
n1824,artifact,,artifact,1,1,2,1,1,2,11,0.201459,0.213701,1139.562417,2,0.00018
n1825,membership,,membership,1,1,2,1,1,2,14,0.119226,0.122033,5110.166667,2,0.000165
n1826,food,,food,1,1,2,1,1,2,13,0.1353,0.139145,5122.166667,2,0.000199
n1827,choices,,choices,1,1,2,1,1,2,12,0.156385,0.162092,5134.166667,2,0.000228
n1828,attributed,,attributed,1,1,2,1,1,2,10,0.193826,0.204573,2817.27848,2,0.000171
n1829,backscheideretal1993,,backscheideretal1993,1,1,2,1,1,2,15,0.109407,0.111714,7697.876131,2,0.000155
n1830,inagakihatano2002,,inagakihatano2002,1,1,2,1,1,2,14,0.1228,0.125815,7709.876131,2,0.000191
n1831,keil1992,,keil1992,1,1,2,1,1,2,13,0.13993,0.144152,7721.876131,2,0.000221
n1832,opfergelman2001,,opfergelman2001,1,1,2,1,1,2,12,0.162614,0.16908,7733.876131,2,0.000247
n1833,opfersiegler2004,,opfersiegler2004,3,3,6,3,3,6,11,0.194075,0.205349,26787.313755,2,0.000609
n1834,correctly,,correctly,2,2,4,2,2,4,14,0.12407,0.127802,15575.313796,2,0.000318
n1835,distinguish,,distinguish,1,1,2,1,1,2,13,0.141192,0.145788,7741.987619,2,0.000194
n1836,living,,living,2,2,4,2,2,4,12,0.164331,0.17157,11211.947601,2,0.000352
n1837,nonliving,,nonliving,2,2,4,2,2,4,12,0.163828,0.171007,9641.919472,2,0.000314
n1838,selectively,,selectively,1,1,2,1,1,2,12,0.165134,0.171974,931.079175,19,0.000189
n1839,applying,,applying,2,2,4,2,2,4,11,0.197706,0.209557,4025.476225,19,0.000316
n1840,immobile,,immobile,2,2,4,2,2,4,11,0.194266,0.205583,12935.978529,2,0.000329
n1841,adults’,,adults’,1,1,2,1,1,2,12,0.155825,0.161467,2602.789496,2,0.000185
n1842,application,,application,1,1,2,1,1,2,11,0.184509,0.193817,2614.789496,2,0.000216
n1843,‘‘alive’’,,‘‘alive’’,1,1,2,1,1,2,12,0.172604,0.180353,353.554833,12,0.000156
n1844,stimuli,,stimuli,1,1,2,1,1,2,12,0.1701,0.177724,389.73274,7,0.000194
n1845,classify,,classify,1,1,2,1,1,2,14,0.137033,0.141391,240.439722,2,0.000166
n1846,contrast,,contrast,1,1,2,1,1,2,11,0.191957,0.20222,1294.33257,2,0.000171
n1847,encounter,,encounter,1,1,2,1,1,2,16,0.099473,0.101568,2555,2,0.000155
n1848,difficulty,,difficulty,1,1,2,1,1,2,15,0.110418,0.113094,2567,2,0.000191
n1849,assigning,,assigning,1,1,2,1,1,2,15,0.116105,0.118763,5289.326176,2,0.000194
n1850,word,,word,1,1,2,1,1,2,14,0.131288,0.134892,5301.326176,2,0.000224
n1851,alive,,alive,1,1,2,1,1,2,13,0.151041,0.15633,5313.326176,2,0.000249
n1852,carey1985,,carey1985,1,1,2,1,1,2,14,0.122818,0.125825,5115,2,0.000186
n1853,hatanoetal1993,,hatanoetal1993,1,1,2,1,1,2,13,0.139946,0.14416,5127,2,0.000217
n1854,meuniercordier2004,,meuniercordier2004,1,1,2,1,1,2,12,0.162624,0.169084,5139,2,0.000244
n1855,richardssiegler1984,,richardssiegler1984,1,1,2,1,1,2,1,1,1,2557,2,0.000231
n1856,waxman2005,,waxman2005,1,0,1,1,0,1,0,0,0,0,2,0.000256
n1857,primarily,,primarily,1,1,2,1,1,2,10,0.221973,0.238251,0,5,0.000162
n1858,planning,,planning,2,2,4,2,2,4,12,0.16311,0.170328,5263.842606,11,0.000245
n1859,datausing,,datausing,1,1,2,1,1,2,11,0.196902,0.20825,187.394448,12,0.000169
n1860,computational,,computational,1,1,2,1,1,2,11,0.204134,0.217075,125.56823,16,0.000155
n1861,constructing,,constructing,3,3,6,3,3,6,10,0.23924,0.259417,9452.108391,5,0.000344
n1862,obtaining,,obtaining,1,1,2,1,1,2,11,0.185321,0.194928,352.131621,0,0.000154
n1863,supporting,,supporting,2,2,4,2,2,4,10,0.227559,0.245665,1941.915645,5,0.000269
n1864,claims,,claims,2,2,4,2,2,4,11,0.229963,0.248822,2331.350518,5,0.000264
n1865,less,,less,2,2,4,2,2,4,12,0.169337,0.177804,4882.119584,10,0.000292
n1866,fulp2002,,fulp2002,1,1,2,1,1,2,1,1,1,2557,10,0.000161
n1867,trygstadetal2013,,trygstadetal2013,1,0,1,1,0,1,0,0,0,0,10,0.000196
n1868,concern,,concern,1,2,3,2,2,4,11,0.175915,0.184029,2674.235161,14,0.000262
n1869,interface,,interface,1,1,2,1,1,2,11,0.195762,0.20699,891.14964,14,0.00017
n1870,immersion,,immersion,1,1,2,1,1,2,11,0.207465,0.219827,548.554244,23,0.000148
n1871,strategically,,strategically,1,1,2,1,1,2,11,0.181805,0.190729,278.0991,20,0.000158
n1872,selected,,selected,2,2,4,2,2,4,10,0.222107,0.238692,5724.665014,20,0.000292
n1873,domains,,domains,1,1,2,1,1,2,12,0.15648,0.162598,441.548358,18,0.000151
n1874,centrality,,centrality,2,2,4,2,2,4,11,0.188615,0.198646,3530.508743,5,0.00027
n1875,c,,c,2,2,4,2,2,4,12,0.183206,0.19249,4333.49469,16,0.000268
n1876,entwining,,entwining,1,1,2,1,1,2,11,0.195717,0.206948,617.842115,16,0.000173
n1877,processthe,,processthe,1,1,2,1,1,2,11,0.189604,0.199494,791.014769,22,0.000159
n1878,toplevel,,toplevel,1,1,2,1,1,2,11,0.195063,0.206101,57.886021,19,0.000152
n1879,categorization,,categorization,1,2,3,2,2,4,11,0.197493,0.209287,4608.75889,16,0.000233
n1880,subgoals,,subgoals,2,2,4,2,2,4,11,0.220524,0.238376,1092.08507,16,0.000271
n1881,delight,,delight,1,1,2,1,1,2,12,0.171018,0.178487,713.582492,12,0.000166
n1882,illstructured,,illstructured,1,1,2,1,1,2,12,0.158695,0.164723,292.699578,8,0.0002
n1883,feature,,feature,2,2,4,2,2,4,12,0.172883,0.180961,5305.518692,19,0.000281
n1884,albeit,,albeit,1,1,2,1,1,2,12,0.171509,0.179216,228.834145,19,0.000178
n1885,top,,top,1,1,2,1,1,2,11,0.187486,0.19709,91.671362,4,0.000152
n1886,assessment,,assessment,1,1,2,1,1,2,12,0.180274,0.188886,78.08131,15,0.000161
n1887,mayr1997,,mayr1997,1,1,2,1,1,2,12,0.157189,0.163015,111.580265,0,0.000181
n1888,“an,,“an,1,1,2,1,1,2,15,0.103274,0.10536,10214,15,0.00015
n1889,unexplained,,unexplained,1,1,2,1,1,2,14,0.115126,0.117772,10226,15,0.000187
n1890,irregularity,,irregularity,1,1,2,1,1,2,13,0.130052,0.133619,10238,15,0.000217
n1891,anomaly”,,anomaly”,1,1,2,1,1,2,12,0.149424,0.154615,10250,15,0.000244
n1892,arises,,arises,1,1,2,1,1,2,11,0.175578,0.183936,10262,15,0.000266
n1893,“puzzle”,,“puzzle”,1,1,2,1,1,2,11,0.192851,0.203363,127.025456,23,0.000146
n1894,emerges,,emerges,5,5,10,5,5,10,10,0.238817,0.259472,15628.561366,23,0.000664
n1895,conjectures,,conjectures,2,2,4,2,2,4,11,0.191928,0.203037,3289.101446,21,0.000318
n1896,puzzle,,puzzle,1,1,2,1,1,2,12,0.184073,0.192781,164.164736,11,0.000149
n1897,thereof,,thereof,1,1,2,1,1,2,11,0.220259,0.237763,661.525995,11,0.000165
n1898,simply,,simply,3,3,6,5,5,10,11,0.192316,0.2038,4648.883211,11,0.000531
n1899,“making,,“making,1,1,2,3,3,6,11,0.20347,0.215674,741.547741,11,0.00033
n1900,carefully,,carefully,1,1,2,3,3,6,11,0.17898,0.187651,388.774549,12,0.000354
n1901,happens”,,happens”,1,2,3,3,3,6,11,0.184536,0.194588,4493.980565,9,0.000324
n1902,driveretalp141,,driveretalp141,1,1,2,1,1,2,11,0.220259,0.237763,1061.539046,9,0.000151
n1903,strong,,strong,3,3,6,4,4,8,11,0.180756,0.18994,11818.142642,4,0.000506
n1904,naïve,,naïve,2,1,3,3,3,6,11,0.194266,0.204632,6104.54304,4,0.000418
n1905,realism,,realism,1,2,3,3,3,6,10,0.241014,0.261387,6116.54304,4,0.000414
n1906,p141,,p141,2,3,5,3,3,6,10,0.226116,0.244711,6680.200438,9,0.000412
n1907,phenomenonbased,,phenomenonbased,1,1,2,1,1,2,12,0.155759,0.161726,3211.758918,9,0.000166
n1908,reasoning”,,reasoning”,1,1,2,1,1,2,11,0.184456,0.194244,3223.758918,9,0.0002
n1909,secondary,,secondary,3,3,6,3,3,6,11,0.191256,0.202896,3542.371387,10,0.000445
n1910,manifested,,manifested,1,1,2,1,1,2,11,0.179807,0.188362,315.172634,16,0.000152
n1911,subsequent,,subsequent,2,2,4,2,2,4,10,0.219169,0.234984,5372.17001,16,0.000276
n1912,relationbased,,relationbased,2,1,3,2,2,4,11,0.192836,0.204166,12989.258169,16,0.000417
n1913,away,,away,1,1,2,1,1,2,11,0.192677,0.202947,2555,16,0.000166
n1914,phenomenology,,phenomenology,1,1,2,1,1,2,10,0.238595,0.258577,2567,16,0.0002
n1915,conceptualized,,conceptualized,1,1,2,1,1,2,11,0.180375,0.189376,0,14,0.00015
n1916,variableshowever,,variableshowever,1,1,2,1,1,2,16,0.098364,0.100299,10214,1,0.000183
n1917,driveretal’s,,driveretal’s,1,1,2,1,1,2,15,0.109049,0.111443,10226,1,0.000214
n1918,finer,,finer,1,1,2,1,1,2,14,0.122338,0.125467,10238,1,0.000241
n1919,grained,,grained,1,1,2,1,1,2,13,0.139315,0.143689,10250,1,0.000264
n1920,specification,,specification,1,1,2,1,1,2,12,0.161764,0.168416,10262,1,0.000283
n1921,vestiges,,vestiges,1,1,2,1,1,2,12,0.162727,0.168907,124.328633,4,0.00017
n1922,observable,,observable,1,1,2,1,1,2,11,0.17454,0.182366,222.195562,14,0.000156
n1923,“takenforgranted,,“takenforgranted,1,1,2,1,1,2,11,0.191971,0.201878,350.480845,14,0.00016
n1924,p115,,p115,2,2,4,2,2,4,10,0.218572,0.234363,4635.933272,22,0.000301
n1925,assume,,assume,1,1,2,1,1,2,13,0.143648,0.148134,2984.527648,20,0.000152
n1926,onetoone,,onetoone,1,1,2,1,1,2,12,0.16769,0.174606,2996.527648,20,0.000188
n1927,factor,,factor,1,1,2,1,1,2,11,0.17943,0.187944,798.26636,22,0.000157
n1928,minority,,minority,1,1,2,1,1,2,14,0.122326,0.125463,7662,16,0.000162
n1929,16yearolds,,16yearolds,1,1,2,1,1,2,13,0.139315,0.143695,7674,16,0.000197
n1930,exhibited,,exhibited,1,1,2,1,1,2,12,0.161784,0.168434,7686,16,0.000226
n1931,modelbased,,modelbased,1,1,2,1,1,2,11,0.192894,0.2042,7698,16,0.000251
n1932,conceptualizing,,conceptualizing,1,1,2,1,1,2,10,0.238617,0.258596,2157.160644,16,0.000168
n1933,“provisional,,“provisional,1,1,2,1,1,2,16,0.099779,0.101723,10845.680087,14,0.000151
n1934,status”,,status”,1,1,2,1,1,2,15,0.110795,0.11321,10857.680087,14,0.000187
n1935,“arise,,“arise,1,1,2,1,1,2,14,0.124545,0.127719,10869.680087,14,0.000218
n1936,directly,,directly,1,1,2,1,1,2,13,0.142193,0.146662,10881.680087,14,0.000244
n1937,data”,,data”,1,1,2,1,1,2,12,0.165667,0.172533,10893.680087,14,0.000266
n1938,“coherent,,“coherent,1,1,2,1,1,2,12,0.162727,0.169167,2782.431571,14,0.000239
n1939,stories”,,stories”,1,1,2,1,1,2,11,0.194207,0.205209,2794.431571,14,0.000262
n1940,“posited,,“posited,1,1,2,1,1,2,11,0.182322,0.191406,1545.28503,12,0.000156
n1941,entities”,,entities”,1,1,2,1,1,2,15,0.111813,0.114165,7662,11,0.000172
n1942,involving,,involving,1,1,2,1,1,2,14,0.125839,0.128932,7674,11,0.000205
n1943,“imagination,,“imagination,1,1,2,1,1,2,13,0.14389,0.148254,7686,11,0.000233
n1944,conjecture”,,conjecture”,1,1,2,1,1,2,12,0.167986,0.174725,7698,11,0.000257
n1945,of“model”as,,of“model”as,1,1,2,1,1,2,12,0.166818,0.173707,2545.509172,11,0.000154
n1946,elaborated,,elaborated,2,2,4,2,2,4,11,0.20014,0.212102,10352.254762,11,0.000376
n1947,lehrerschauble2000,,lehrerschauble2000,1,1,2,1,1,2,12,0.185268,0.19524,418.136821,12,0.00016
n1948,representational,,representational,2,2,4,2,2,4,11,0.209975,0.223996,5121,12,0.000283
n1949,syntactic,,syntactic,1,1,2,1,1,2,12,0.171692,0.179142,2555,0,0.000151
n1950,analogical,,analogical,1,1,2,1,1,2,11,0.207247,0.22049,2567,0,0.000187
n1951,hypotheticaldeductive,,hypotheticaldeductive,1,1,2,1,1,2,11,0.20723,0.220425,0,0,0.000151
n1952,subsequently,,subsequently,1,1,2,1,1,2,11,0.179217,0.188084,574.093662,13,0.00016
n1953,adequacy,,adequacy,1,1,2,1,1,2,10,0.208543,0.221762,441.547097,4,0.000168
n1954,instrument,,instrument,1,1,2,1,1,2,12,0.159483,0.165644,2555,7,0.000162
n1955,addressing,,addressing,1,1,2,1,1,2,11,0.189674,0.200104,2567,7,0.000197
n1956,policy,,policy,1,2,3,1,2,3,12,0.179996,0.188531,5158.009125,21,0.000191
n1957,situating,,situating,1,1,2,1,1,2,10,0.222011,0.238284,996.68844,1,0.000165
n1958,center,,center,1,1,2,1,1,2,11,0.206763,0.219401,0,5,0.000153
n1959,trend,,trend,1,1,2,1,1,2,11,0.189171,0.199226,1077.537176,0,0.000146
n1960,recent,,recent,2,2,4,2,2,4,11,0.210147,0.223649,1176.951784,20,0.00027
n1961,osborne2014,,osborne2014,1,1,2,1,1,2,12,0.161094,0.167235,6708.080556,18,0.000153
n1962,osborne,,osborne,1,1,2,1,1,2,11,0.191957,0.202156,6720.080556,18,0.000189
n1963,commitment,,commitment,1,1,2,1,1,2,11,0.204964,0.21833,618.846453,13,0.000175
n1964,beliefs,,beliefs,1,1,2,1,1,2,13,0.152594,0.157839,5146.009125,21,0.000155
n1965,reforms,,reforms,1,1,2,1,1,2,12,0.16001,0.166134,60.186484,21,0.00014
n1966,aligned,,aligned,1,1,2,1,1,2,11,0.205967,0.218933,234.297085,14,0.000168
n1967,adopting,,adopting,1,1,2,1,1,2,11,0.205046,0.216883,160.77694,5,0.000153
n1968,alongside,,alongside,2,2,4,2,2,4,12,0.169999,0.17742,5368.117081,23,0.000251
n1969,core,,core,2,2,4,2,2,4,11,0.224515,0.240624,1480.29709,16,0.000264
n1970,exemplified,,exemplified,1,1,2,1,1,2,11,0.217682,0.231804,224.967406,11,0.000151
n1971,ngss,,ngss,1,1,2,1,1,2,13,0.145208,0.14989,2665.455048,18,0.000147
n1972,achieve2013,,achieve2013,1,1,2,1,1,2,12,0.169819,0.177093,2677.455048,18,0.000184
n1973,nrc2012,,nrc2012,2,2,4,2,2,4,11,0.204475,0.217274,7830.132736,18,0.000321
n1974,examination,,examination,1,1,2,1,1,2,10,0.209873,0.222409,769.709229,18,0.000195
n1975,7,,7,1,1,2,1,1,2,11,0.209975,0.223411,425.749752,0,0.000146
n1976,evidenceexplanation,,evidenceexplanation,1,1,2,1,1,2,12,0.14718,0.151699,5175.611698,1,0.000207
n1977,ee,,ee,1,1,2,1,1,2,11,0.172499,0.179519,5187.611698,1,0.000235
n1978,continuum,,continuum,1,1,2,1,1,2,10,0.20834,0.220655,5199.611698,1,0.000259
n1979,transformations,,transformations,1,1,2,1,1,2,11,0.196225,0.207638,504.293659,11,0.00015
n1980,judgments1selecting,,judgments1selecting,1,1,2,1,1,2,13,0.14052,0.144671,5110.810277,0,0.000163
n1981,generatingd,,generatingd,1,1,2,1,1,2,12,0.163421,0.16968,5122.810277,0,0.000198
n1982,ata,,ata,1,1,2,1,1,2,11,0.195241,0.205766,5134.810277,0,0.000227
n1983,evidence2using,,evidence2using,1,1,2,1,1,2,11,0.204932,0.218298,466.243137,0,0.000169
n1984,ascertain,,ascertain,1,1,2,1,1,2,12,0.170643,0.178344,177.208923,0,0.000154
n1985,employing,,employing,1,1,2,1,1,2,11,0.207247,0.22049,422.027288,0,0.000155
n1986,propos,,propos,1,1,2,1,1,2,10,0.207297,0.220097,371.58331,0,0.000164
n1987,duschl,,duschl,2,2,4,2,2,4,12,0.175614,0.1842,11019.776273,21,0.000356
n1988,outeach,,outeach,1,1,2,1,1,2,12,0.14718,0.151699,5109,21,0.000168
n1989,se,,se,1,1,2,1,1,2,11,0.172499,0.179519,5121,21,0.000202
n1990,transitions,,transitions,1,1,2,1,1,2,10,0.20834,0.220655,5133,21,0.00023
n1991,judgments,,judgments,1,1,2,1,1,2,12,0.151148,0.156627,2631.683636,0,0.000148
n1992,“what,,“what,1,1,2,1,1,2,11,0.178012,0.186831,2643.683636,0,0.000185
n1993,counts”,,counts”,2,2,4,2,2,4,10,0.21649,0.232809,7222.003245,0,0.000324
n1994,howeverour,,howeverour,1,1,2,1,1,2,11,0.194134,0.20534,275.689007,20,0.000158
n1995,kindergarteners,,kindergarteners,1,1,2,1,1,2,12,0.16001,0.166576,196.633751,20,0.00016
n1996,focuses,,focuses,2,2,4,2,2,4,11,0.190448,0.201655,3292.803444,20,0.000293
n1997,claimsselecting,,claimsselecting,1,1,2,1,1,2,11,0.186087,0.195662,118.278871,12,0.000157
n1998,evidenceidentifying,,evidenceidentifying,1,1,2,1,1,2,12,0.163828,0.170575,2568.157305,0,0.000169
n1999,patternsand,,patternsand,1,1,2,1,1,2,11,0.195866,0.207448,2580.157305,0,0.000203
n2000,focusing,,focusing,2,2,4,2,2,4,12,0.169942,0.177571,5455.64311,7,0.000261
n2001,words,,words,2,2,4,2,2,4,11,0.212935,0.228439,2110.597075,11,0.000273
n2002,discursive,,discursive,3,3,6,3,3,6,11,0.198977,0.211416,5148.306835,23,0.000366
n2003,talk,,talk,4,4,8,4,4,8,10,0.214967,0.228986,4498.966554,0,0.000501
n2004,claim,,claim,5,5,10,5,5,10,10,0.232041,0.252226,29150.961745,5,0.000571
n2005,second,,second,4,4,8,4,4,8,11,0.197265,0.210656,21778.868961,9,0.000557
n2006,appropriateness,,appropriateness,1,1,2,1,1,2,11,0.205473,0.219416,1411.546753,9,0.000177
n2007,selecting,,selecting,1,1,2,1,1,2,11,0.205473,0.219416,1079.868936,7,0.000156
n2008,potential,,potential,2,2,4,2,2,4,11,0.200688,0.212388,1478.473297,12,0.000254
n2009,disconfirm,,disconfirm,1,1,2,1,1,2,11,0.188408,0.19874,401.859176,5,0.00015
n2010,scaffolded,,scaffolded,1,1,2,1,1,2,11,0.175278,0.183257,1365.518575,7,0.000149
n2011,comprised,,comprised,1,1,2,1,1,2,12,0.172604,0.180353,141.154417,12,0.000143
n2012,step1,,step1,1,1,2,1,1,2,12,0.168393,0.175746,176.070679,12,0.000159
n2013,introduces,,introduces,1,2,3,2,2,4,10,0.246118,0.268571,401.026721,15,0.000251
n2014,day,,day,3,3,6,3,3,6,10,0.225699,0.243582,10076.013965,7,0.000381
n2015,demonstration,,demonstration,1,1,2,1,1,2,11,0.193155,0.20372,119.024775,7,0.000167
n2016,fiction,,fiction,1,1,2,1,1,2,15,0.113178,0.115669,5109,3,0.00015
n2017,nonfiction,,nonfiction,1,1,2,1,1,2,14,0.127577,0.130888,5121,3,0.000187
n2018,book,,book,1,1,2,1,1,2,13,0.146175,0.150909,5133,3,0.000218
n2019,step2,,step2,1,1,2,1,1,2,12,0.164457,0.171291,467.71768,3,0.000201
n2020,asks,,asks,2,2,4,2,2,4,12,0.171269,0.17897,3079.98354,7,0.000296
n2021,outcome,,outcome,1,1,2,1,1,2,13,0.142976,0.147806,2555,13,0.000171
n2022,step3,,step3,1,1,2,1,1,2,12,0.166753,0.174248,2567,13,0.000204
n2023,encouraged,,encouraged,4,4,8,4,4,8,10,0.220335,0.236928,9920.691829,21,0.000463
n2024,“wrap,,“wrap,1,1,2,1,1,2,11,0.200829,0.21292,127.118367,18,0.000157
n2025,activities”,,activities”,2,2,4,2,2,4,12,0.18236,0.191247,7696.967272,23,0.000286
n2026,facilitate,,facilitate,1,1,2,1,1,2,11,0.216874,0.231368,3612.170811,23,0.00018
n2027,map,,map,1,1,2,1,1,2,12,0.164058,0.17068,2873.243387,18,0.000145
n2028,representations,,representations,1,1,2,1,1,2,10,0.237294,0.256826,4251.466611,18,0.000193
n2029,onto,,onto,1,1,2,1,1,2,11,0.200813,0.212901,436.464573,18,0.000154
n2030,step4,,step4,1,1,2,1,1,2,11,0.176035,0.183426,131.441616,12,0.000164
n2031,chart,,chart,1,1,2,1,1,2,12,0.15988,0.166383,224.103408,20,0.000156
n2032,verbal,,verbal,1,1,2,1,1,2,11,0.176035,0.183426,138.586752,20,0.00017
n2033,sociocognitive,,sociocognitive,1,1,2,1,1,2,10,0.221227,0.236953,511.640876,16,0.000153
n2034,resembling,,resembling,2,2,4,2,2,4,11,0.201807,0.214456,5478.664562,6,0.000245
n2035,communities,,communities,1,1,2,1,1,2,11,0.178024,0.186582,2628.643179,12,0.000151
n2036,pose,,pose,1,1,2,1,1,2,10,0.216508,0.232195,2640.643179,12,0.000187
n2037,analyse,,analyse,2,2,4,2,2,4,11,0.206182,0.220471,2959.782859,0,0.000263
n2038,reconstruct,,reconstruct,1,1,2,1,1,2,11,0.179782,0.188912,173.774684,16,0.000154
n2039,gottduggan,,gottduggan,1,1,2,1,1,2,14,0.135172,0.139118,5109,5,0.000156
n2040,1995,,1995,1,1,2,1,1,2,13,0.156252,0.162109,5121,5,0.000191
n2041,etkinavanheuvelen2007,,etkinavanheuvelen2007,1,1,2,1,1,2,12,0.185121,0.194765,5133,5,0.000222
n2042,blumniss1991,,blumniss1991,1,1,2,1,1,2,14,0.123349,0.126378,5162.259587,5,0.000163
n2043,erickson1999,,erickson1999,1,1,2,1,1,2,13,0.140651,0.144876,5174.259587,5,0.000197
n2044,lubienski1999,,lubienski1999,1,1,2,1,1,2,12,0.163598,0.170012,5186.259587,5,0.000227
n2045,constantinou1999,,constantinou1999,1,1,2,1,1,2,14,0.120332,0.123177,7662,5,0.00022
n2046,english2003,,english2003,1,1,2,1,1,2,13,0.136727,0.14064,7674,5,0.000246
n2047,leshlehrer2003,,leshlehrer2003,1,1,2,1,1,2,12,0.158294,0.16413,7686,5,0.000268
n2048,loucazacharia2012,,loucazacharia2012,1,1,2,1,1,2,11,0.187939,0.197625,7698,5,0.000287
n2049,nuanced,,nuanced,1,1,2,1,1,2,12,0.162841,0.169858,2563.351249,11,0.000154
n2050,meanings,,meanings,1,1,2,1,1,2,11,0.194457,0.206497,2575.351249,11,0.00019
n2051,surrounds,,surrounds,2,2,4,2,2,4,11,0.226475,0.245758,1836.472389,23,0.000237
n2052,generic,,generic,1,1,2,1,1,2,12,0.166483,0.173347,2555,20,0.000146
n2053,epistemological,,epistemological,1,1,2,1,1,2,11,0.199673,0.211422,2567,20,0.000183
n2054,cpd,,cpd,1,1,2,1,1,2,13,0.159672,0.166055,253.703089,9,0.000181
n2055,facilitators,,facilitators,1,1,2,1,1,2,12,0.162224,0.168335,2564.760256,18,0.000151
n2056,impose,,impose,1,1,2,1,1,2,11,0.193548,0.203836,2576.760256,18,0.000187
n2057,epistemologically,,epistemologically,1,1,2,1,1,2,12,0.180922,0.189673,2531.236296,3,0.00015
n2058,inquiring,,inquiring,1,1,2,1,1,2,12,0.167242,0.173891,2555,16,0.000148
n2059,researching,,researching,1,1,2,1,1,2,11,0.200766,0.212223,2567,16,0.000184
n2060,seemed,,seemed,1,1,2,1,1,2,12,0.159821,0.165757,195.748616,16,0.000146
n2061,strongly,,strongly,2,2,4,2,2,4,11,0.190166,0.200132,4521.299213,16,0.000277
n2062,change,,change,1,1,2,1,1,2,11,0.184218,0.193668,72.626046,21,0.000166
n2063,viewed,,viewed,2,2,4,2,2,4,10,0.225719,0.243686,3785.432325,21,0.000286
n2064,higherorder,,higherorder,1,1,2,1,1,2,11,0.204117,0.217056,1218.110979,16,0.000162
n2065,earlyetal2005,,earlyetal2005,1,1,2,1,1,2,12,0.180553,0.189965,2555,9,0.000144
n2066,laparoetal2004,,laparoetal2004,1,1,2,1,1,2,11,0.220259,0.237763,2567,9,0.000181
n2067,zechetal2000,,zechetal2000,1,1,2,1,1,2,11,0.195434,0.206922,0,21,0.000166
n2068,originated,,originated,1,1,2,1,1,2,11,0.201096,0.212844,758.537343,12,0.000154
n2069,sessions,,sessions,1,1,2,1,1,2,12,0.179117,0.187891,1867.169963,4,0.000166
n2070,enough,,enough,3,3,6,3,3,6,11,0.212021,0.226894,5832.499289,9,0.000406
n2071,correct,,correct,1,1,2,1,1,2,12,0.173256,0.180865,270.337939,12,0.000159
n2072,explorations,,explorations,1,1,2,1,1,2,13,0.143312,0.147964,2586.114359,4,0.000168
n2073,emphasizing,,emphasizing,1,1,2,1,1,2,12,0.167209,0.174434,2598.114359,4,0.000202
n2074,slp,,slp,2,3,5,2,3,5,11,0.193914,0.204831,17922.333333,0,0.000384
n2075,program,,program,1,1,2,1,1,2,10,0.237338,0.256848,10410.5368,0,0.000168
n2076,grounded,,grounded,1,1,2,1,1,2,11,0.186736,0.196452,158.027268,5,0.000146
n2077,panel,,panel,1,1,2,1,1,2,15,0.115141,0.117834,5112.433478,21,0.000172
n2078,experts,,experts,1,1,2,1,1,2,14,0.130071,0.133705,5124.433478,21,0.000205
n2079,summarized,,summarized,1,1,2,1,1,2,13,0.14945,0.154746,5136.433478,21,0.000233
n2080,grandy2008these,,grandy2008these,1,1,2,1,1,2,11,0.186764,0.196485,2017.714312,21,0.00021
n2081,validation,,validation,1,1,2,1,1,2,12,0.173795,0.18211,420.300515,19,0.000152
n2082,sociocultural,,sociocultural,2,2,4,2,2,4,10,0.208222,0.222323,3332.826221,0,0.000287
n2083,norms,,norms,3,3,6,3,3,6,10,0.209633,0.224125,3700.852019,0,0.000372
n2084,sets,,sets,1,1,2,1,1,2,11,0.172384,0.180253,87.998742,0,0.000161
n2085,members,,members,1,1,2,1,1,2,10,0.221973,0.238251,269.893749,16,0.000157
n2086,coconstruct,,coconstruct,1,1,2,1,1,2,12,0.152521,0.157977,2620.189522,14,0.00016
n2087,evaluateand,,evaluateand,1,1,2,1,1,2,11,0.179908,0.188728,2632.189522,14,0.000195
n2088,knowledgethese,,knowledgethese,1,1,2,1,1,2,12,0.163546,0.170188,2555,14,0.000161
n2089,scholars,,scholars,1,1,2,1,1,2,11,0.195449,0.206935,2567,14,0.000195
n2090,agree,,agree,1,1,2,1,1,2,11,0.192158,0.202727,503.815136,21,0.000151
n2091,plays,,plays,1,1,2,1,1,2,11,0.196948,0.208017,484.159487,19,0.000158
n2092,regulation,,regulation,1,1,2,1,1,2,10,0.237272,0.256806,252.635721,0,0.000148
n2093,revising,,revising,1,1,2,1,1,2,11,0.207281,0.220541,1471.843023,0,0.00017
n2094,worldwe,,worldwe,1,1,2,1,1,2,11,0.192706,0.202979,2555,0,0.000151
n2095,posit,,posit,1,1,2,1,1,2,10,0.238617,0.258596,2567,0,0.000187
n2096,shaped,,shaped,2,2,4,2,2,4,11,0.195359,0.206538,4645.236897,16,0.000274
n2097,unique,,unique,1,1,2,1,1,2,11,0.195732,0.206968,381.516822,16,0.000175
n2098,constructed,,constructed,3,3,6,3,3,6,10,0.209342,0.223186,5532.64059,16,0.000348
n2099,disciplines,,disciplines,1,2,3,2,2,4,11,0.191228,0.201948,2630.555699,2,0.000271
n2100,modelsas,,modelsas,1,1,2,1,1,2,11,0.18443,0.194092,398.928022,3,0.000172
n2101,chinnsamarapungavan2008,,chinnsamarapungavan2008,1,1,2,1,1,2,14,0.122718,0.125744,5109,0,0.000151
n2102,suppes19601962,,suppes19601962,1,1,2,1,1,2,13,0.139831,0.144044,5121,0,0.000187
n2103,woodward1989,,woodward1989,1,1,2,1,1,2,12,0.162491,0.168876,5133,0,0.000218
n2104,acquiring,,acquiring,1,1,2,1,1,2,13,0.139293,0.143387,2719.24388,11,0.000152
n2105,certain,,certain,1,1,2,1,1,2,12,0.161774,0.167997,2731.24388,11,0.000188
n2106,vocabulary,,vocabulary,3,3,6,3,3,6,10,0.214375,0.229279,7932.867144,11,0.000369
n2107,“theories”,,“theories”,1,1,2,1,1,2,14,0.118878,0.121772,5109,20,0.00015
n2108,“laws”,,“laws”,1,1,2,1,1,2,13,0.134874,0.138856,5121,20,0.000187
n2109,“hypotheses”,,“hypotheses”,1,1,2,1,1,2,12,0.155844,0.161794,5133,20,0.000217
n2110,ongoing,,ongoing,2,2,4,2,2,4,11,0.200281,0.212414,4474.609177,20,0.000281
n2111,debates,,debates,1,1,2,1,1,2,11,0.173069,0.180796,176.736904,20,0.000178
n2112,utility,,utility,1,1,2,1,1,2,11,0.180388,0.189389,157.759957,14,0.000175
n2113,history,,history,1,1,2,1,1,2,11,0.192244,0.202505,46.233331,14,0.000156
n2114,philosophy,,philosophy,2,2,4,2,2,4,10,0.23791,0.257798,3847.832541,14,0.000288
n2115,cartwright19831999,,cartwright19831999,1,1,2,1,1,2,14,0.125164,0.128342,5202.74559,11,0.000152
n2116,giere1988kuhn1962,,giere1988kuhn1962,1,1,2,1,1,2,13,0.143024,0.147503,5214.74559,11,0.000188
n2117,laudan1990,,laudan1990,1,1,2,1,1,2,12,0.166829,0.173717,5226.74559,11,0.000219
n2118,publications,,publications,1,1,2,1,1,2,12,0.16248,0.168869,10209.333333,0,0.000165
n2119,starts,,starts,1,1,2,1,1,2,11,0.191928,0.202039,2555,0,0.000168
n2120,premise,,premise,1,1,2,1,1,2,10,0.23736,0.256855,2567,0,0.000202
n2121,spaces,,spaces,1,1,2,1,1,2,12,0.173596,0.181414,162.01179,12,0.000156
n2122,conventions,,conventions,1,1,2,1,1,2,10,0.218182,0.233673,713.29487,12,0.000179
n2123,criteria,,criteria,1,1,2,1,1,2,11,0.185348,0.194961,89.025348,0,0.000164
n2124,samarapungavanetal20082009,,samarapungavanetal20082009,1,1,2,1,1,2,11,0.22024,0.237743,425.994366,9,0.000152
n2125,preinquiry,,preinquiry,1,1,2,1,1,2,11,0.207398,0.220819,2532.684547,19,0.000178
n2126,everyday,,everyday,2,2,4,2,2,4,10,0.221513,0.238388,3263.231538,14,0.000266
n2127,postinquiry,,postinquiry,1,1,2,1,1,2,11,0.207398,0.220819,1389.46264,9,0.000166
n2128,consisted,,consisted,1,1,2,1,1,2,12,0.16247,0.168955,1639.873818,7,0.000159
n2129,presentations,,presentations,1,1,2,1,1,2,11,0.193083,0.204225,263.563046,21,0.000163
n2130,reviewed,,reviewed,1,1,2,1,1,2,11,0.182283,0.191669,633.170445,14,0.000152
n2131,emphasize,,emphasize,0,1,1,0,1,1,12,0.172509,0.180059,0,23,0.000059
n2132,dialectical,,dialectical,2,2,4,2,2,4,11,0.208391,0.221878,10267.333333,23,0.000302
n2133,interacting,,interacting,2,2,4,2,2,4,10,0.231936,0.250602,12922.563309,5,0.000308
n2134,coconstructing,,coconstructing,1,1,2,1,1,2,10,0.237251,0.256774,0,18,0.000146
n2135,perspectives,,perspectives,1,1,2,1,1,2,13,0.155054,0.160876,249.6989,1,0.000178
n2136,analytic,,analytic,1,1,2,1,1,2,11,0.193155,0.20372,1183.848806,1,0.000171
n2137,sections,,sections,1,1,2,1,1,2,11,0.220259,0.237763,926.567565,21,0.000174
n2138,forusscience,,forusscience,1,1,2,1,1,2,12,0.167144,0.17412,2559.13376,1,0.000166
n2139,human,,human,2,2,4,2,2,4,11,0.200625,0.212919,3928.258351,1,0.000334
n2140,existence,,existence,1,1,2,1,1,2,12,0.177006,0.184981,163.571722,14,0.000172
n2141,interactants,,interactants,1,1,2,1,1,2,14,0.135058,0.138983,274.65464,10,0.000173
n2142,continually,,continually,2,2,4,2,2,4,13,0.156071,0.162029,8128.386144,10,0.000309
n2143,situated,,situated,1,1,2,1,1,2,11,0.188008,0.197365,320.793844,4,0.00017
n2144,“doing”which,,“doing”which,1,1,2,1,1,2,11,0.193519,0.203671,116.059715,11,0.000172
n2145,dialoaic,,dialoaic,1,1,2,1,1,2,11,0.187994,0.197352,370.809104,11,0.000164
n2146,ash2004we,,ash2004we,1,1,2,1,1,2,11,0.197538,0.208415,107.39,11,0.000171
n2147,talked,,talked,1,1,2,1,1,2,14,0.128361,0.13172,7662.333333,23,0.000164
n2148,gallas1995,,gallas1995,1,1,2,1,1,2,13,0.147206,0.152013,7674.333333,23,0.000198
n2149,lemke1990,,lemke1990,1,1,2,1,1,2,12,0.172534,0.18008,7686.333333,23,0.000227
n2150,depiction,,depiction,1,1,2,1,1,2,12,0.16043,0.166533,204.882078,1,0.000165
n2151,depicts,,depicts,1,1,2,1,1,2,11,0.186168,0.195916,751.598554,23,0.000156
n2152,as“multiple,,as“multiple,1,1,2,1,1,2,12,0.167329,0.174139,3433.012348,23,0.000151
n2153,systematically,,systematically,2,2,4,2,2,4,11,0.200876,0.212661,8301.069238,23,0.000351
n2154,elements”,,elements”,1,1,2,1,1,2,12,0.161094,0.167187,5109,5,0.00019
n2155,engestrommiettinen1999p9through,,engestrommiettinen1999p9through,1,1,2,1,1,2,11,0.191928,0.202039,5121,5,0.00022
n2156,frameworks,,frameworks,1,1,2,1,1,2,10,0.23736,0.256855,5133,5,0.000246
n2157,learningthinking,,learningthinking,1,1,2,1,1,2,12,0.155958,0.161727,6085.247831,3,0.000152
n2158,addressed,,addressed,1,1,2,1,1,2,11,0.207482,0.219846,1871.236485,3,0.00017
n2159,moment,,moment,1,1,2,1,1,2,13,0.138811,0.14294,5109,24,0.000154
n2160,becoming,,becoming,1,1,2,1,1,2,12,0.161134,0.167319,5121,24,0.00019
n2161,participant,,participant,1,1,2,1,1,2,11,0.192014,0.202293,5133,24,0.00022
n2162,“doing,,“doing,4,2,6,4,4,8,10,0.237536,0.257429,13520.820601,24,0.000571
n2163,organize,,organize,2,3,5,3,3,6,10,0.238064,0.258573,5294.630851,5,0.000356
n2164,expand,,expand,2,2,4,2,2,4,10,0.223752,0.240629,3349.509535,1,0.000306
n2165,pertain,,pertain,1,1,2,1,1,2,12,0.161205,0.167367,2755.172599,23,0.000153
n2166,sciencespecific,,sciencespecific,1,1,2,1,1,2,11,0.192115,0.202351,2767.172599,23,0.000189
n2167,“just,,“just,1,1,2,1,1,2,13,0.134605,0.138557,5109,23,0.000164
n2168,go,,go,1,1,2,1,1,2,12,0.155486,0.161381,5121,23,0.000198
n2169,pouring,,pouring,1,1,2,1,1,2,11,0.184033,0.193855,5133,23,0.000228
n2170,volume”,,volume”,1,1,2,1,1,2,15,0.117868,0.12082,2640.317888,23,0.000159
n2171,organization,,organization,1,1,2,1,1,2,14,0.133569,0.137649,2652.317888,23,0.000194
n2172,sciencerelated,,sciencerelated,2,2,4,2,2,4,13,0.154095,0.160292,10425.1938,23,0.000316
n2173,discoursein,,discoursein,1,1,2,1,1,2,12,0.178892,0.188209,5593.136911,23,0.000193
n2174,fromfeeds,,fromfeeds,1,1,2,1,1,2,13,0.143368,0.148105,5111,23,0.000193
n2175,intoand,,intoand,1,1,2,1,1,2,12,0.167286,0.174607,5123,23,0.000223
n2176,constitutes,,constitutes,1,1,2,1,1,2,11,0.200782,0.213522,5135,23,0.000248
n2177,larger,,larger,1,1,2,1,1,2,11,0.202348,0.214908,178.353384,23,0.000167
n2178,discourseininteraction,,discourseininteraction,1,1,2,1,1,2,12,0.167329,0.174139,2288.05689,23,0.000193
n2179,goal–orientated,,goal–orientated,1,1,2,1,1,2,12,0.178867,0.188177,2998.591378,23,0.000152
n2180,argue,,argue,1,1,2,1,1,2,11,0.195583,0.206901,754.650694,1,0.000164
n2181,children’ssciencerelated,,children’ssciencerelated,1,1,2,1,1,2,11,0.176981,0.184608,150.715545,0,0.000153
n2182,alowquality,,alowquality,1,1,2,1,1,2,12,0.162707,0.169271,708.58813,20,0.000178
n2183,standardized,,standardized,2,2,4,2,2,4,12,0.169337,0.177102,15380.062406,6,0.000365
n2184,ore,,ore,1,1,2,1,1,2,12,0.156901,0.163059,2971.245328,6,0.000214
n2185,stablished,,stablished,1,1,2,1,1,2,11,0.186006,0.196274,2983.245328,6,0.000241
n2186,sciencequite,,sciencequite,1,1,2,1,1,2,12,0.168382,0.175648,2573.565792,23,0.000168
n2187,contrarythese,,contrarythese,1,1,2,1,1,2,11,0.20238,0.214931,2585.565792,23,0.000202
n2188,precedeand,,precedeand,1,1,2,1,1,2,15,0.112395,0.114999,5165.47176,6,0.000152
n2189,atthe,,atthe,1,1,2,1,1,2,14,0.126584,0.130044,5177.47176,6,0.000188
n2190,origin,,origin,1,1,2,1,1,2,13,0.144872,0.149811,5189.47176,6,0.000219
n2191,canonical,,canonical,1,1,2,1,1,2,11,0.20238,0.214931,9864.817078,6,0.000214
n2192,schliebenlange1987,,schliebenlange1987,1,1,2,1,1,2,11,0.19333,0.203809,546.851314,16,0.000169
n2193,norm,,norm,2,2,4,2,2,4,11,0.202014,0.214239,1806.172798,16,0.000267
n2194,conceptualize,,conceptualize,1,1,2,1,1,2,10,0.237251,0.256774,0,9,0.000166
n2195,science”,,science”,2,4,6,4,4,8,11,0.211202,0.225197,3144.160609,24,0.000553
n2196,institutional,,institutional,1,1,2,1,1,2,11,0.168338,0.175329,128.963757,3,0.000158
n2197,locally,,locally,1,1,2,1,1,2,12,0.145934,0.150505,5110,24,0.000156
n2198,organized,,organized,1,1,2,1,1,2,11,0.170801,0.177863,5122,24,0.000191
n2199,sequentially,,sequentially,1,1,2,1,1,2,10,0.205885,0.218153,5134,24,0.000222
n2200,rooted,,rooted,1,1,2,1,1,2,12,0.174741,0.182724,122.236023,16,0.000165
n2201,configuring,,configuring,1,1,2,1,1,2,11,0.188726,0.199106,488.189314,23,0.000164
n2202,structures,,structures,2,2,4,2,2,4,11,0.192086,0.20259,5534.387635,23,0.00026
n2203,sequencing,,sequencing,1,1,2,1,1,2,13,0.15429,0.159738,378.837091,23,0.000169
n2204,pekarekdoehlerziegler2007p85,,pekarekdoehlerziegler2007p85,1,1,2,1,1,2,11,0.20238,0.214931,1540.796461,23,0.00018
n2205,continuously,,continuously,1,1,2,1,1,2,11,0.190589,0.200615,0,23,0.000152
n2206,consequently,,consequently,1,1,2,1,1,2,11,0.200735,0.213493,439.590174,23,0.000169
n2207,acknowledged,,acknowledged,1,1,2,1,1,2,12,0.15989,0.165921,2742.755986,16,0.000168
n2208,“science”,,“science”,1,1,2,1,1,2,11,0.190236,0.200333,2754.755986,16,0.000202
n2209,imply,,imply,1,1,2,1,1,2,12,0.147003,0.151929,5109,16,0.000163
n2210,lesser,,lesser,1,1,2,1,1,2,11,0.172268,0.179985,5121,16,0.000198
n2211,normative,,normative,1,1,2,1,1,2,10,0.208019,0.221729,5133,16,0.000227
n2212,“do,,“do,1,1,2,1,1,2,12,0.174421,0.182071,922.810714,24,0.000153
n2213,informal,,informal,1,1,2,1,1,2,10,0.237272,0.256806,2617.785175,21,0.000164
n2214,ash2004,,ash2004,1,1,2,1,1,2,11,0.22024,0.237743,220.405672,20,0.000151
n2215,goaloriented,,goaloriented,2,2,4,2,2,4,10,0.213395,0.228186,1201.751184,23,0.000282
n2216,frames,,frames,1,1,2,1,1,2,11,0.216837,0.231336,901.981018,23,0.000159
n2217,mutual,,mutual,1,1,2,1,1,2,12,0.17888,0.188196,794.72415,2,0.000167
n2218,creates,,creates,1,1,2,1,1,2,11,0.202348,0.214908,414.440821,23,0.000164
n2219,practicesthey,,practicesthey,1,1,2,1,1,2,10,0.209838,0.222387,863.959955,23,0.000164
n2220,modify,,modify,1,1,2,1,1,2,11,0.202332,0.214889,126.249152,23,0.000153
n2221,collaboratively,,collaboratively,2,2,4,2,2,4,11,0.171052,0.178366,2938.769509,24,0.000264
n2222,orient,,orient,1,1,2,1,1,2,11,0.201238,0.213093,2144.37133,24,0.000171
n2223,format,,format,1,1,2,1,1,2,12,0.161937,0.168277,2555,23,0.000152
n2224,completing,,completing,1,1,2,1,1,2,11,0.193141,0.203912,2567,23,0.000188
n2225,reveal,,reveal,1,1,2,1,1,2,10,0.237294,0.256826,2611.550544,23,0.000169
n2226,unfolding,,unfolding,1,1,2,1,1,2,11,0.19301,0.203844,77.833325,23,0.000158
n2227,reallife,,reallife,1,1,2,1,1,2,10,0.218108,0.233606,1685.931383,15,0.000168
n2228,energy,,energy,2,2,4,2,2,4,11,0.220486,0.238272,6096.31579,2,0.000244
n2229,lijnse1990,,lijnse1990,1,1,2,1,1,2,13,0.136277,0.140647,2573.244914,2,0.000163
n2230,trumper1990,,trumper1990,1,1,2,1,1,2,12,0.15771,0.164332,2585.244914,2,0.000197
n2231,vanhooketal2005,,vanhooketal2005,1,1,2,1,1,2,12,0.159533,0.165861,2565.445175,14,0.000163
n2232,vanhookhuziakclark2007b,,vanhookhuziakclark2007b,1,1,2,1,1,2,11,0.18973,0.200294,2577.445175,14,0.000198
n2233,conception,,conception,1,1,2,1,1,2,12,0.17001,0.177206,114.206736,18,0.000158
n2234,air,,air,1,1,2,1,1,2,13,0.152948,0.158374,2604.628655,7,0.000154
n2235,magnetism,,magnetism,1,1,2,1,1,2,12,0.180502,0.189229,2616.628655,7,0.00019
n2236,lessons,,lessons,3,3,6,3,3,6,11,0.211602,0.225983,4868.719293,5,0.000369
n2237,combine,,combine,1,1,2,1,1,2,11,0.197614,0.208821,82.60195,5,0.000164
n2238,succinct,,succinct,1,1,2,1,1,2,12,0.16897,0.17627,2553.351611,19,0.000144
n2239,phrases,,phrases,2,2,4,2,2,4,11,0.203245,0.216039,7862.911942,19,0.000369
n2240,hooks,,hooks,1,3,4,3,3,6,11,0.191242,0.202742,12865.743887,19,0.000347
n2241,capture,,capture,2,1,3,2,2,4,11,0.196948,0.208017,10546.905434,19,0.000368
n2242,reinforcement,,reinforcement,1,1,2,1,1,2,12,0.171819,0.17936,135.254047,18,0.000154
n2243,multisensory,,multisensory,2,1,3,2,2,4,11,0.207398,0.220819,2767.767004,5,0.000277
n2244,ripe,,ripe,5,3,8,5,5,10,11,0.217664,0.233751,9420.167932,5,0.000578
n2245,aid,,aid,1,1,2,1,1,2,11,0.19728,0.208329,81.67866,5,0.000157
n2246,dealing,,dealing,1,1,2,1,1,2,12,0.169897,0.17697,2555,18,0.000146
n2247,abstract,,abstract,1,1,2,1,1,2,11,0.204605,0.217028,2567,18,0.000183
n2248,examines,,examines,1,1,2,1,1,2,12,0.163048,0.169383,2572.935588,16,0.000144
n2249,effect,,effect,1,1,2,1,1,2,11,0.194752,0.205437,2584.935588,16,0.000181
n2250,kinesthetic,,kinesthetic,1,1,2,1,1,2,13,0.14141,0.145695,5109,19,0.000149
n2251,movements,,movements,1,1,2,1,1,2,12,0.164636,0.171146,5121,19,0.000186
n2252,songs,,songs,1,1,2,1,1,2,11,0.196993,0.208059,5133,19,0.000217
n2253,remember,,remember,1,1,2,1,1,2,11,0.179643,0.188161,573.293179,13,0.000152
n2254,intensely,,intensely,1,1,2,1,1,2,12,0.168992,0.176289,438.295927,21,0.00017
n2255,address,,address,1,1,2,1,1,2,12,0.185268,0.19524,345.571996,12,0.000149
n2256,phrased,,phrased,1,1,2,1,1,2,12,0.161754,0.168575,4218.208961,21,0.000156
n2257,reinforced,,reinforced,1,1,2,1,1,2,13,0.144603,0.149314,2717.560331,10,0.00019
n2258,brief,,brief,1,1,2,1,1,2,12,0.168981,0.176279,2729.560331,10,0.000221
n2259,articulate,,articulate,1,1,2,1,1,2,10,0.221973,0.238251,487.925024,21,0.000152
n2260,notions,,notions,1,1,2,1,1,2,12,0.152385,0.157849,1890.616702,5,0.000151
n2261,variety,,variety,1,1,2,1,1,2,10,0.218126,0.233619,2612.602297,5,0.000189
n2262,“lift”,,“lift”,1,1,2,1,1,2,15,0.110295,0.112643,7662,19,0.000157
n2263,“squeeze”,,“squeeze”,1,1,2,1,1,2,14,0.123926,0.126993,7674,19,0.000193
n2264,“stretch”,,“stretch”,1,1,2,1,1,2,13,0.141402,0.145685,7686,19,0.000223
n2265,“twist”,,“twist”,1,1,2,1,1,2,12,0.164615,0.171124,7698,19,0.000248
n2266,overall,,overall,1,1,2,1,1,2,12,0.165645,0.172757,108.653506,5,0.000165
n2267,devolve,,devolve,1,1,2,1,1,2,12,0.155825,0.161467,2555,12,0.000146
n2268,lecture,,lecture,1,1,2,1,1,2,11,0.184509,0.193817,2567,12,0.000183
n2269,flourish,,flourish,1,1,2,1,1,2,11,0.205967,0.218933,167.979705,5,0.000144
n2270,phase1,,phase1,4,4,8,4,4,8,11,0.201776,0.215006,3003.730721,9,0.000481
n2271,figure,,figure,1,1,2,1,1,2,11,0.179908,0.188382,1788.501499,2,0.000163
n2272,helmkatz2011,,helmkatz2011,3,2,5,3,2,5,11,0.191199,0.202323,3721.529026,7,0.000359
n2273,ideally,,ideally,1,1,2,1,1,2,10,0.224692,0.241963,998.521804,7,0.000211
n2274,initiate,,initiate,2,2,4,2,2,4,10,0.232798,0.251758,8153.447168,21,0.000238
n2275,due,,due,1,1,2,1,1,2,10,0.205456,0.217594,116.68093,16,0.000163
n2276,constraints,,constraints,1,1,2,1,1,2,13,0.150864,0.156114,2590.004386,9,0.000167
n2277,mini,,mini,1,1,2,1,1,2,12,0.177593,0.18603,2602.004386,9,0.000201
n2278,introduced,,introduced,1,1,2,1,1,2,12,0.169092,0.176769,147.28254,9,0.000181
n2279,rain,,rain,7,7,14,7,7,14,10,0.228003,0.248075,38923.786396,7,0.001065
n2280,weather,,weather,2,2,4,2,2,4,11,0.187077,0.197185,1807.277803,1,0.000288
n2281,extracted,,extracted,1,1,2,1,1,2,11,0.192144,0.202789,10895.565951,0,0.000202
n2282,afterwards,,afterwards,1,1,2,1,1,2,12,0.150837,0.156016,2591.092308,14,0.000172
n2283,explored,,explored,1,1,2,1,1,2,11,0.177557,0.185894,2603.092308,14,0.000205
n2284,books,,books,1,1,2,1,1,2,11,0.185737,0.196044,441.236244,2,0.000165
n2285,returned,,returned,1,1,2,1,1,2,13,0.140574,0.145151,1236.760924,0,0.000169
n2286,knew,,knew,1,1,2,1,1,2,11,0.18575,0.196053,2006.518016,0,0.000189
n2287,phase2,,phase2,1,1,2,1,1,2,11,0.181126,0.189897,91.385874,9,0.000145
n2288,indepth,,indepth,1,1,2,1,1,2,10,0.20856,0.221782,652.503162,7,0.000161
n2289,twoweek,,twoweek,1,1,2,1,1,2,12,0.156671,0.16289,2653.354624,7,0.000158
n2290,span,,span,1,1,2,1,1,2,11,0.185724,0.196031,2665.354624,7,0.000193
n2291,measure,,measure,1,1,2,1,1,2,12,0.166407,0.173827,238.239418,7,0.000188
n2292,mathematic,,mathematic,1,1,2,1,1,2,11,0.214895,0.229605,665.183666,12,0.000162
n2293,performed,,performed,1,1,2,1,1,2,11,0.18571,0.196011,1165.293428,7,0.000151
n2294,referenced,,referenced,1,1,2,1,1,2,12,0.1606,0.16735,296.560718,10,0.000206
n2295,continued,,continued,1,1,2,1,1,2,11,0.179142,0.187566,2555,11,0.000152
n2296,showcase,,showcase,1,1,2,1,1,2,10,0.218163,0.23366,2567,11,0.000188
n2297,writings,,writings,1,1,2,1,1,2,11,0.193083,0.204225,207.740548,3,0.000165
n2298,phase3,,phase3,1,1,2,1,1,2,13,0.150828,0.156075,2588.445389,9,0.000145
n2299,wrap,,wrap,1,1,2,1,1,2,12,0.177569,0.186008,2600.445389,9,0.000182
n2300,culminating,,culminating,1,1,2,1,1,2,11,0.193126,0.203903,691.490754,23,0.000181
n2301,experiencepeters2006,,experiencepeters2006,1,1,2,1,1,2,12,0.173092,0.180947,136.773764,21,0.000151
n2302,‘but’,,‘but’,1,1,2,1,1,2,12,0.162635,0.169231,2564.31733,20,0.000169
n2303,rop2002,,rop2002,1,1,2,1,1,2,11,0.194148,0.205353,2576.31733,20,0.000203
n2304,–,,–,4,4,8,4,4,8,10,0.240901,0.26237,17123.245021,16,0.000451
n2305,‘receptive,,‘receptive,2,2,4,2,2,4,11,0.181049,0.19038,5300.321591,16,0.000258
n2306,contexts’,,contexts’,1,1,2,1,1,2,10,0.21649,0.232176,2149.554419,16,0.000169
n2307,outpouring,,outpouring,1,1,2,1,1,2,10,0.216471,0.232143,1343.136147,12,0.000166
n2308,parents,,parents,1,1,2,1,1,2,12,0.146333,0.15098,0,7,0.000157
n2309,ambivalent,,ambivalent,1,1,2,1,1,2,11,0.177593,0.18609,811.12627,7,0.000183
n2310,listen,,listen,1,1,2,1,1,2,11,0.203261,0.215105,1065.572328,22,0.000158
n2311,child’s,,child’s,6,6,12,6,6,12,10,0.25499,0.279438,24242.738499,16,0.000928
n2312,contradictory,,contradictory,1,1,2,1,1,2,13,0.155091,0.161088,2593.772035,8,0.000157
n2313,feelings,,feelings,1,1,2,1,1,2,12,0.183494,0.193443,2605.772035,8,0.000192
n2314,‘honour’,,‘honour’,1,1,2,1,1,2,11,0.203229,0.215073,887.111703,8,0.000174
n2315,give,,give,1,1,2,1,1,2,11,0.200719,0.213473,1232.375115,23,0.000169
n2316,struggle,,struggle,1,1,2,1,1,2,10,0.204442,0.216122,213.330156,5,0.00015
n2317,weighed,,weighed,1,1,2,1,1,2,14,0.134345,0.138364,5109,8,0.000155
n2318,seemingly,,seemingly,1,1,2,1,1,2,13,0.155129,0.161117,5121,8,0.00019
n2319,incompatible,,incompatible,1,1,2,1,1,2,12,0.18352,0.193459,5133,8,0.000221
n2320,maximize,,maximize,1,1,2,1,1,2,15,0.111842,0.114331,7667,8,0.000174
n2321,‘teaching,,‘teaching,1,1,2,1,1,2,14,0.125882,0.129173,7679,8,0.000207
n2322,time’,,time’,1,1,2,1,1,2,13,0.143954,0.148616,7691,8,0.000235
n2323,‘cover,,‘cover,1,1,2,1,1,2,12,0.168085,0.175305,7703,8,0.000259
n2324,school’,,school’,1,1,2,1,1,2,14,0.128793,0.13211,5112.2,2,0.000205
n2325,‘get,,‘get,1,1,2,1,1,2,13,0.147765,0.152515,5124.2,2,0.000233
n2326,things’,,things’,1,1,2,1,1,2,12,0.173291,0.180766,5136.2,2,0.000257
n2327,compassionate,,compassionate,1,1,2,1,1,2,11,0.199611,0.212769,2273.553646,10,0.000183
n2328,perceive,,perceive,1,1,2,1,1,2,11,0.203229,0.215073,1050.890887,7,0.000157
n2329,annoying,,annoying,1,1,2,1,1,2,15,0.102609,0.104617,10214,0,0.000155
n2330,‘going,,‘going,1,1,2,1,1,2,14,0.114301,0.116825,10226,0,0.00019
n2331,grain’,,grain’,1,1,2,1,1,2,13,0.129,0.132367,10238,0,0.000221
n2332,impediment,,impediment,1,1,2,1,1,2,12,0.148037,0.152869,10250,0,0.000247
n2333,overbearing,,overbearing,1,1,2,1,1,2,11,0.173666,0.181285,10262,0,0.000268
n2334,patience,,patience,2,2,4,2,2,4,12,0.164331,0.171533,3037.651134,15,0.00034
n2335,arrive,,arrive,1,1,2,1,1,2,12,0.154216,0.160056,176.079614,15,0.000185
n2336,received,,received,1,1,2,1,1,2,14,0.1353,0.139349,5111.116667,12,0.000166
n2337,‘common,,‘common,1,1,2,1,1,2,13,0.156404,0.162427,5123.116667,12,0.0002
n2338,wisdom’,,wisdom’,1,1,2,1,1,2,12,0.185308,0.195269,5135.116667,12,0.000229
n2339,adult,,adult,2,2,4,2,2,4,10,0.199875,0.213211,10583.129115,2,0.000354
n2340,‘why’,,‘why’,1,1,2,1,1,2,10,0.21649,0.232176,846.831786,12,0.000168
n2341,rapid,,rapid,1,1,2,1,1,2,13,0.139315,0.143595,3018.272286,10,0.000159
n2342,succession,,succession,1,1,2,1,1,2,12,0.161805,0.168301,3030.272286,10,0.000194
n2343,exhorting,,exhorting,1,1,2,1,1,2,13,0.141737,0.146251,115.900856,15,0.000204
n2344,power,,power,1,1,2,1,1,2,12,0.142587,0.147013,2666.938919,15,0.000199
n2345,‘because,,‘because,1,1,2,1,1,2,11,0.166224,0.173053,2678.938919,15,0.000228
n2346,so’,,so’,1,1,2,1,1,2,10,0.19387,0.204614,960.306576,15,0.000198
n2347,attitudes,,attitudes,1,1,2,1,1,2,12,0.177262,0.18549,1987.357588,4,0.000155
n2348,discouraged,,discouraged,1,1,2,1,1,2,11,0.181202,0.190383,137.838582,9,0.000157
n2349,nursery,,nursery,1,1,2,1,1,2,11,0.200735,0.213493,274.097874,9,0.000159
n2350,concerned,,concerned,1,1,2,1,1,2,13,0.143512,0.147941,5109,14,0.000157
n2351,‘micropolitics’,,‘micropolitics’,1,1,2,1,1,2,12,0.167504,0.174309,5121,14,0.000193
n2352,‘real’,,‘real’,1,1,2,1,1,2,11,0.201128,0.212876,5133,14,0.000223
n2353,pedrosadejesusetal2012,,pedrosadejesusetal2012,1,1,2,1,1,2,12,0.149528,0.154242,2577.800125,20,0.00016
n2354,illustrates,,illustrates,1,1,2,1,1,2,11,0.175746,0.183219,2589.800125,20,0.000195
n2355,contextsensitive,,contextsensitive,1,1,2,1,1,2,11,0.195568,0.206194,550.826876,20,0.000178
n2356,context’,,context’,1,1,2,1,1,2,11,0.194767,0.20545,606.767173,16,0.000169
n2357,occasion,,occasion,2,2,4,2,2,4,12,0.168692,0.175772,12780.785676,15,0.000292
n2358,brezillon20032005,,brezillon20032005,1,1,2,1,1,2,11,0.186222,0.195413,2081.548728,15,0.000183
n2359,‘physical,,‘physical,1,1,2,1,1,2,13,0.13751,0.141749,583.495668,5,0.00015
n2360,intellectual,,intellectual,1,1,2,1,1,2,11,0.189074,0.199141,4538.388803,5,0.000179
n2361,meaning’,,meaning’,1,1,2,1,1,2,14,0.123974,0.127072,7662,15,0.000165
n2362,caudron2000p55,,caudron2000p55,1,1,2,1,1,2,13,0.141464,0.145796,7674,15,0.000199
n2363,‘positive,,‘positive,1,1,2,1,1,2,12,0.1647,0.171289,7686,15,0.000228
n2364,receptive,,receptive,1,1,2,1,1,2,11,0.197069,0.208289,7698,15,0.000253
n2365,questioning’,,questioning’,1,1,2,1,1,2,12,0.162152,0.168436,2620.974308,15,0.00017
n2366,moves,,moves,1,1,2,1,1,2,11,0.193446,0.203965,2632.974308,15,0.000204
n2367,usual,,usual,1,1,2,1,1,2,10,0.208003,0.221719,392.22097,18,0.000175
n2368,prime,,prime,1,1,2,1,1,2,12,0.167111,0.173955,2560.999491,2,0.000152
n2369,criterion,,criterion,1,1,2,1,1,2,11,0.200578,0.212332,2572.999491,2,0.000188
n2370,environmentwhere,,environmentwhere,1,1,2,1,1,2,11,0.216855,0.231355,402.463448,2,0.000171
n2371,arepositive,,arepositive,1,1,2,1,1,2,13,0.151353,0.15638,5109,3,0.000147
n2372,numerous,,numerous,1,1,2,1,1,2,12,0.178284,0.186278,5121,3,0.000184
n2373,instances,,instances,1,1,2,1,1,2,11,0.216874,0.231368,5133,3,0.000216
n2374,dismissed,,dismissed,1,1,2,1,1,2,12,0.155363,0.161043,2678.927467,2,0.000155
n2375,welcomed,,welcomed,1,1,2,1,1,2,11,0.183875,0.193158,2690.927467,2,0.00019
n2376,acted,,acted,1,1,2,1,1,2,11,0.220278,0.237776,1390.257223,2,0.000188
n2377,answerable,,answerable,1,1,2,1,1,2,12,0.185255,0.195221,974.475687,12,0.000155
n2378,wattspedrosadejesus2006,,wattspedrosadejesus2006,1,1,2,1,1,2,11,0.182464,0.191995,235.539861,12,0.000172
n2379,mode,,mode,1,1,2,1,1,2,11,0.173385,0.181569,150.594047,21,0.00018
n2380,resolution,,resolution,1,1,2,1,1,2,11,0.178049,0.186604,2868.259759,7,0.000206
n2381,‘investigable’,,‘investigable’,1,1,2,1,1,2,10,0.216526,0.232208,2880.259759,7,0.000234
n2382,chinkayalvizhi2002,,chinkayalvizhi2002,3,3,6,3,3,6,12,0.169516,0.177306,8227.084192,12,0.000369
n2383,graessermcmahen1993,,graessermcmahen1993,1,1,2,1,1,2,12,0.158754,0.164605,128.109703,12,0.000164
n2384,‘but,,‘but,1,1,2,1,1,2,12,0.149511,0.154225,2555,20,0.000166
n2385,science’,,science’,1,1,2,1,1,2,11,0.175734,0.183209,2567,20,0.0002
n2386,ingredients,,ingredients,1,2,3,2,2,4,11,0.179908,0.188977,3259.571826,14,0.000244
n2387,years,,years,1,2,3,2,2,4,11,0.196315,0.207567,5159.078006,18,0.000248
n2388,‘empirical,,‘empirical,1,1,2,1,1,2,13,0.14155,0.146379,2602.361111,9,0.000167
n2389,questionasking’,,questionasking’,1,1,2,1,1,2,12,0.164827,0.172343,2614.361111,9,0.000201
n2390,‘transgressive,,‘transgressive,1,1,2,1,1,2,15,0.117314,0.120194,10214,9,0.000177
n2391,play’,,play’,1,1,2,1,1,2,14,0.132844,0.136767,10226,9,0.00021
n2392,third,,third,1,1,2,1,1,2,13,0.153112,0.158879,10238,9,0.000237
n2393,‘good,,‘good,1,1,2,1,1,2,12,0.18068,0.190033,10250,9,0.000261
n2394,thinking’,,thinking’,1,1,2,1,1,2,11,0.220354,0.237802,10262,9,0.00028
n2395,tack,,tack,1,1,2,1,1,2,11,0.213006,0.227086,0,9,0.000166
n2396,manifest,,manifest,1,1,2,1,1,2,11,0.207448,0.219794,780.148049,23,0.000146
n2397,vastly,,vastly,1,1,2,1,1,2,11,0.195598,0.206914,667.85348,1,0.000162
n2398,solely,,solely,1,1,2,1,1,2,11,0.186628,0.196078,119.940367,1,0.000167
n2399,works,,works,1,1,2,1,1,2,12,0.15574,0.161574,2555,3,0.000152
n2400,powerfully,,powerfully,1,1,2,1,1,2,11,0.184417,0.194079,2567,3,0.000188
n2401,entailed,,entailed,1,1,2,1,1,2,11,0.207465,0.219827,377.582382,23,0.000149
n2402,arnold2009,,arnold2009,1,1,2,1,1,2,11,0.19333,0.20361,4052.528211,12,0.000164
n2403,pathway,,pathway,1,1,2,1,1,2,13,0.151522,0.156917,69.333072,20,0.000183
n2404,collected,,collected,1,2,3,2,2,4,11,0.163629,0.170838,1393.312854,0,0.000256
n2405,fully,,fully,2,2,4,2,2,4,11,0.202046,0.214156,2914.116267,5,0.000287
n2406,conceptually,,conceptually,1,1,2,1,1,2,11,0.189436,0.199117,352.227013,12,0.000155
n2407,remaining,,remaining,1,1,2,1,1,2,12,0.16488,0.171478,1667.667417,9,0.000153
n2408,spring,,spring,1,1,2,1,1,2,13,0.14328,0.148025,2586.442857,11,0.000145
n2409,odd,,odd,1,1,2,1,1,2,12,0.167187,0.174534,2598.442857,11,0.000182
n2410,passing,,passing,1,1,2,1,1,2,12,0.178668,0.186943,160.170551,11,0.000176
n2411,technological,,technological,1,1,2,1,1,2,11,0.182024,0.191626,408.75187,12,0.000171
n2412,difficult,,difficult,1,1,2,1,1,2,11,0.185764,0.196512,543.553303,12,0.000156
n2413,occurrence,,occurrence,1,1,2,1,1,2,12,0.167504,0.174391,35.773665,15,0.000171
n2414,tv,,tv,1,1,2,1,1,2,15,0.109277,0.111597,7665,15,0.000156
n2415,advert,,advert,1,1,2,1,1,2,14,0.122642,0.125667,7677,15,0.000191
n2416,pet’s,,pet’s,1,1,2,1,1,2,13,0.139732,0.143948,7689,15,0.000222
n2417,habits,,habits,1,1,2,1,1,2,12,0.162357,0.168754,7701,15,0.000247
n2418,family,,family,2,2,4,2,2,4,11,0.193724,0.204657,18424.236947,15,0.000393
n2419,sporting,,sporting,1,1,2,1,1,2,13,0.144367,0.148838,409.462057,15,0.000166
n2420,obsessions,,obsessions,1,1,2,1,1,2,12,0.171451,0.179036,2822.418813,15,0.000226
n2421,hobbies,,hobbies,1,1,2,1,1,2,11,0.206813,0.220241,2834.418813,15,0.000251
n2422,‘disequilibrium,,‘disequilibrium,1,1,2,1,1,2,12,0.15404,0.159853,2597.07458,12,0.000149
n2423,detection’,,detection’,1,1,2,1,1,2,11,0.182024,0.191626,2609.07458,12,0.000186
n2424,wattspedrosadejesus2010,,wattspedrosadejesus2010,1,1,2,1,1,2,12,0.181587,0.19024,386.504182,20,0.000155
n2425,clash,,clash,1,1,2,1,1,2,11,0.193972,0.205878,605.047848,6,0.000152
n2426,‘life,,‘life,1,1,2,1,1,2,12,0.151989,0.157239,5109,23,0.000156
n2427,issues’,,issues’,1,1,2,1,1,2,11,0.179167,0.187588,5121,23,0.000192
n2428,overlay,,overlay,1,1,2,1,1,2,10,0.218182,0.233673,5133,23,0.000222
n2429,informative,,informative,1,1,2,1,1,2,12,0.156863,0.163031,2591.346769,9,0.000159
n2430,sourcesthroughouttheearlyyearswattsalsop1995in,,sourcesthroughouttheearlyyearswattsalsop1995in,1,1,2,1,1,2,11,0.185979,0.196258,2603.346769,9,0.000194
n2431,precurser,,precurser,1,1,2,1,1,2,11,0.199984,0.211951,677.409507,11,0.000168
n2432,acceleration,,acceleration,1,1,2,1,1,2,10,0.237272,0.256806,0,19,0.000155
n2433,dissonance,,dissonance,1,1,2,1,1,2,14,0.124787,0.127997,7662,21,0.000155
n2434,mccormacketal2014,,mccormacketal2014,1,1,2,1,1,2,13,0.142524,0.147042,7674,21,0.000191
n2435,said,,said,1,1,2,1,1,2,12,0.166138,0.173068,7686,21,0.000221
n2436,chinkayalvizhi2005,,chinkayalvizhi2005,1,1,2,1,1,2,11,0.199132,0.211075,7698,21,0.000247
n2437,skill,,skill,1,1,2,1,1,2,12,0.170711,0.178219,196.262244,3,0.000155
n2438,thorntonbruton2015,,thorntonbruton2015,1,1,2,1,1,2,12,0.18318,0.192483,163.519048,18,0.000175
n2439,earlyyears,,earlyyears,1,1,2,1,1,2,10,0.238617,0.258596,1096.316899,4,0.000163
n2440,‘reggioemilio,,‘reggioemilio,1,1,2,1,1,2,11,0.183533,0.192705,2555,21,0.00015
n2441,approach’,,approach’,1,1,2,1,1,2,10,0.224711,0.241983,2567,21,0.000187
n2442,opinions,,opinions,3,3,6,3,3,6,11,0.180553,0.189728,5401.609422,1,0.000372
n2443,stands,,stands,1,1,2,1,1,2,14,0.135658,0.139887,112.693598,1,0.000169
n2444,paved,,paved,1,1,2,1,1,2,14,0.119403,0.122426,7674.142857,7,0.000169
n2445,playground,,playground,1,1,2,1,1,2,13,0.135543,0.139709,7686.142857,7,0.000202
n2446,heavy,,heavy,1,1,2,1,1,2,12,0.156729,0.162941,7698.142857,7,0.000231
n2447,spate,,spate,1,1,2,1,1,2,11,0.185764,0.19606,7710.142857,7,0.000255
n2448,‘where,,‘where,1,1,2,1,1,2,11,0.194545,0.20492,1417.736656,18,0.000185
n2449,go’,,go’,1,1,2,1,1,2,11,0.203261,0.215105,84.440176,18,0.000173
n2450,respected,,respected,1,1,2,1,1,2,13,0.143705,0.148268,5109,21,0.000151
n2451,taken,,taken,1,1,2,1,1,2,12,0.167755,0.174793,5121,21,0.000188
n2452,seriously,,seriously,1,1,2,1,1,2,11,0.201475,0.21371,5133,21,0.000218
n2453,thorntonbruton,,thorntonbruton,1,1,2,1,1,2,11,0.166203,0.173037,1801.697686,15,0.00016
n2454,‘children,,‘children,1,1,2,1,1,2,12,0.151612,0.15707,2567.031481,12,0.00015
n2455,unafraid,,unafraid,1,1,2,1,1,2,11,0.178656,0.187548,2579.031481,12,0.000187
n2456,reconstructing,,reconstructing,1,1,2,1,1,2,12,0.142905,0.147707,2577.73591,2,0.000182
n2457,ideas’2015p17,,ideas’2015p17,1,1,2,1,1,2,11,0.166656,0.174151,2589.73591,2,0.000214
n2458,intervenes,,intervenes,1,1,2,1,1,2,13,0.148474,0.15396,235.444093,2,0.00021
n2459,observes,,observes,1,1,2,1,1,2,14,0.126409,0.129565,7662.666667,10,0.000162
n2460,listens,,listens,1,1,2,1,1,2,13,0.144643,0.149093,7674.666667,10,0.000196
n2461,interprets,,interprets,1,1,2,1,1,2,12,0.169025,0.17587,7686.666667,10,0.000226
n2462,facilitates,,facilitates,1,1,2,1,1,2,11,0.203293,0.215121,7698.666667,10,0.000251
n2463,interesting,,interesting,1,1,2,1,1,2,10,0.218108,0.233606,259.641672,5,0.000157
n2464,respect,,respect,1,1,2,1,1,2,12,0.162903,0.169443,2565.439753,19,0.000156
n2465,predetermined,,predetermined,1,1,2,1,1,2,11,0.194531,0.205638,2577.439753,19,0.000191
n2466,determine,,determine,1,1,2,1,1,2,10,0.224711,0.241983,0,19,0.000157
n2467,put,,put,1,1,2,1,1,2,11,0.183783,0.193117,64.213692,16,0.00015
n2468,‘skills,,‘skills,1,1,2,1,1,2,12,0.162501,0.169411,2671.550504,23,0.000151
n2469,expertise,,expertise,1,1,2,1,1,2,11,0.193972,0.205878,2683.550504,23,0.000187
n2470,them’,,them’,1,1,2,1,1,2,1,1,1,2557,23,0.000166
n2471,p86,,p86,1,0,1,1,0,1,0,0,0,0,23,0.0002
n2472,useful,,useful,1,1,2,1,1,2,12,0.161743,0.168412,2555,13,0.000151
n2473,enhancing,,enhancing,1,1,2,1,1,2,11,0.192865,0.204188,2567,13,0.000188
n2474,furnished,,furnished,1,1,2,1,1,2,11,0.177741,0.185874,213.733507,5,0.000165
n2475,mathematical,,mathematical,8,8,16,8,8,16,10,0.25061,0.275072,30497.299202,5,0.00093
n2476,kennedy2009,,kennedy2009,1,1,2,1,1,2,12,0.180553,0.189965,2555,9,0.000154
n2477,nctm2000,,nctm2000,1,1,2,1,1,2,11,0.220259,0.237763,2567,9,0.00019
n2478,positively,,positively,1,1,2,1,1,2,11,0.184099,0.193415,467.836285,23,0.000156
n2479,future,,future,1,1,2,1,1,2,11,0.19333,0.203809,3224.568522,16,0.000145
n2480,discovering,,discovering,3,2,5,3,3,6,10,0.224515,0.241561,1534.615965,12,0.000334
n2481,conflict,,conflict,1,1,2,2,2,4,12,0.173819,0.181356,2589.385966,19,0.000251
n2482,scenarios,,scenarios,1,2,3,2,2,4,11,0.210319,0.223819,2601.385966,19,0.000272
n2483,meaningfully,,meaningfully,1,1,2,1,1,2,10,0.205489,0.217357,346.298093,21,0.000152
n2484,additionally,,additionally,1,1,2,1,1,2,11,0.213006,0.227086,0,9,0.000166
n2485,nrc2000,,nrc2000,1,1,2,1,1,2,11,0.193505,0.203652,299.840084,11,0.000149
n2486,identification,,identification,1,1,2,1,1,2,11,0.173502,0.180617,242.660991,11,0.000161
n2487,consideration,,consideration,1,1,2,1,1,2,11,0.187623,0.197087,307.969416,11,0.000164
n2488,richards1991,,richards1991,1,1,2,1,1,2,11,0.192706,0.202979,2555,18,0.000142
n2489,described,,described,1,1,2,1,1,2,10,0.238617,0.258596,2567,18,0.00018
n2490,mathematically,,mathematically,1,1,2,1,1,2,11,0.209993,0.223431,1208.048136,0,0.000176
n2491,proposing,,proposing,1,1,2,1,1,2,12,0.161084,0.167584,89.170615,21,0.000182
n2492,yackeletal1990,,yackeletal1990,1,1,2,1,1,2,12,0.178259,0.186256,2555,12,0.000154
n2493,claimed,,claimed,1,1,2,1,1,2,11,0.216855,0.231355,2567,12,0.00019
n2494,participative,,participative,1,1,2,1,1,2,10,0.231685,0.250087,0,23,0.000158
n2495,comprehend,,comprehend,1,1,2,1,1,2,13,0.130734,0.134274,2624.191352,6,0.00016
n2496,saw,,saw,1,1,2,1,1,2,12,0.150334,0.155494,2636.191352,6,0.000195
n2497,andor,,andor,2,2,4,2,2,4,11,0.176847,0.185215,7796.109396,6,0.000329
n2498,heard,,heard,1,1,2,1,1,2,11,0.186222,0.195193,1194.061722,6,0.000199
n2499,short,,short,1,1,2,1,1,2,11,0.213006,0.227086,168.647695,11,0.000158
n2500,emphasizes,,emphasizes,1,1,2,1,1,2,12,0.170813,0.178164,2557.268383,5,0.000146
n2501,childcentered,,childcentered,1,1,2,1,1,2,11,0.205951,0.218914,2569.268383,5,0.000183
n2502,“autonomy,,“autonomy,1,1,2,1,1,2,11,0.183533,0.192705,2555,21,0.000153
n2503,manipulation”,,manipulation”,1,1,2,1,1,2,10,0.224711,0.241983,2567,21,0.000189
n2504,solve,,solve,2,2,4,2,2,4,11,0.194295,0.205417,4737.917013,12,0.000276
n2505,firsthand,,firsthand,2,2,4,2,2,4,11,0.22424,0.242259,2156.080117,12,0.000278
n2506,offers,,offers,1,1,2,1,1,2,11,0.199565,0.212704,542.63843,21,0.000151
n2507,abundant,,abundant,1,1,2,1,1,2,11,0.198041,0.20944,539.522796,13,0.000157
n2508,kids’,,kids’,1,1,2,1,1,2,11,0.200453,0.21231,309.25272,13,0.000165
n2509,higherlevel,,higherlevel,1,1,2,1,1,2,11,0.200453,0.21231,62.936835,1,0.000162
n2510,capability,,capability,1,1,2,1,1,2,11,0.195866,0.207448,0,0,0.000158
n2511,enthusiastic,,enthusiastic,1,1,2,1,1,2,12,0.150342,0.155424,2568.579365,22,0.000159
n2512,thinker,,thinker,1,1,2,1,1,2,11,0.176872,0.184949,2580.579365,22,0.000194
n2513,accepting,,accepting,1,1,2,1,1,2,10,0.202972,0.215592,779.570029,1,0.000164
n2514,ultimate,,ultimate,1,1,2,1,1,2,12,0.155901,0.161967,211.624773,14,0.00016
n2515,rationale,,rationale,1,1,2,1,1,2,11,0.172615,0.180087,2574.667111,7,0.00015
n2516,nrc1996nrc2012,,nrc1996nrc2012,1,1,2,1,1,2,10,0.20856,0.221782,2586.667111,7,0.000186
n2517,constructivism,,constructivism,2,2,4,2,2,4,11,0.207297,0.221648,3153.516385,5,0.00027
n2518,bybee1997,,bybee1997,1,1,2,1,1,2,11,0.200562,0.212312,579.398842,2,0.000146
n2519,orgillthomas2007,,orgillthomas2007,1,1,2,1,1,2,11,0.184417,0.194079,136.97868,7,0.000166
n2520,liferelated,,liferelated,1,1,2,1,1,2,11,0.194236,0.205106,0,12,0.000176
n2521,changwu2015,,changwu2015,1,1,2,1,1,2,11,0.220259,0.237763,1058.892639,11,0.000168
n2522,“try,,“try,1,1,2,1,1,2,13,0.136836,0.140774,5218.430195,17,0.000149
n2523,error”,,error”,1,1,2,1,1,2,12,0.158479,0.164343,5230.430195,17,0.000186
n2524,attempts,,attempts,1,1,2,1,1,2,11,0.188256,0.197939,5242.430195,17,0.000217
n2525,constructs,,constructs,1,1,2,1,1,2,11,0.17736,0.185419,442.494477,21,0.000159
n2526,“problematic,,“problematic,1,1,2,1,1,2,11,0.193928,0.205761,0,23,0.000156
n2527,action”,,action”,1,1,2,1,1,2,13,0.139854,0.144079,2658.795418,0,0.00015
n2528,osterman1998p4,,osterman1998p4,1,1,2,1,1,2,12,0.162532,0.168994,2670.795418,0,0.000186
n2529,past,,past,1,1,2,1,1,2,10,0.218089,0.233587,0,11,0.000155
n2530,requiring,,requiring,1,1,2,1,1,2,11,0.216837,0.231336,625.103004,5,0.000148
n2531,full,,full,1,1,2,1,1,2,11,0.188477,0.198234,144.426619,5,0.00015
n2532,precept,,precept,1,1,2,1,1,2,12,0.16814,0.175106,452.412773,5,0.000147
n2533,applied,,applied,2,2,4,2,2,4,11,0.192807,0.203947,481.942889,5,0.000277
n2534,relation,,relation,1,1,2,1,1,2,13,0.133306,0.137302,2597.582289,17,0.000161
n2535,constructivity,,constructivity,1,1,2,1,1,2,12,0.153763,0.159707,2609.582289,17,0.000195
n2536,realistic,,realistic,1,1,2,1,1,2,11,0.183089,0.192295,312.992741,10,0.000153
n2537,manipulatives,,manipulatives,1,1,2,1,1,2,12,0.167144,0.174248,500.800667,10,0.000164
n2538,kids,,kids,1,1,2,1,1,2,10,0.199689,0.212695,676.06517,10,0.000173
n2539,physically,,physically,1,1,2,1,1,2,12,0.162717,0.169141,2560.54329,21,0.00018
n2540,mentally,,mentally,1,1,2,1,1,2,11,0.194251,0.205078,2572.54329,21,0.000212
n2541,summary,,summary,1,1,2,1,1,2,12,0.177569,0.186008,4237.833473,9,0.000166
n2542,dienes’s1973,,dienes’s1973,1,1,2,1,1,2,11,0.199178,0.210766,396.517038,9,0.000181
n2543,36,,36,1,1,2,1,1,2,11,0.213024,0.227105,4258.618204,10,0.000168
n2544,“free,,“free,1,1,2,1,1,2,17,0.087116,0.088672,12765,12,0.000155
n2545,experiments”,,experiments”,1,1,2,1,1,2,16,0.09539,0.097209,12777,12,0.000191
n2546,“comparison”,,“comparison”,1,1,2,1,1,2,15,0.105401,0.107621,12789,12,0.000221
n2547,merged,,merged,1,1,2,1,1,2,14,0.11776,0.120617,12801,12,0.000247
n2548,“problem,,“problem,1,1,2,1,1,2,13,0.133403,0.13733,12813,12,0.000269
n2549,solving”,,solving”,1,1,2,1,1,2,12,0.153837,0.159715,12825,12,0.000287
n2550,“representation”,,“representation”,1,1,2,1,1,2,12,0.161998,0.168197,2588.681161,20,0.0002
n2551,“symbolization”,,“symbolization”,1,1,2,1,1,2,11,0.193243,0.203604,2600.681161,20,0.000229
n2552,integrated,,integrated,2,2,4,2,2,4,10,0.239418,0.25968,11552.934657,20,0.000373
n2553,stimulating,,stimulating,1,1,2,1,1,2,11,0.216855,0.231355,386.262796,20,0.000217
n2554,expression,,expression,2,1,3,2,2,4,11,0.19612,0.20684,1250.154885,0,0.000254
n2555,“fourstage,,“fourstage,1,1,2,1,1,2,14,0.127552,0.130901,5131.7338,8,0.000155
n2556,developmental,,developmental,1,1,2,1,1,2,13,0.146133,0.150908,5143.7338,8,0.000191
n2557,model”,,model”,1,1,2,1,1,2,12,0.171052,0.178508,5155.7338,8,0.000221
n2558,sequential,,sequential,1,1,2,1,1,2,10,0.231727,0.250119,4071.805606,8,0.0002
n2559,free,,free,2,1,3,2,2,4,11,0.187939,0.197999,607.371883,1,0.000245
n2560,exercising,,exercising,1,1,2,1,1,2,12,0.15404,0.159853,2577.953968,12,0.000155
n2561,brain,,brain,1,1,2,1,1,2,11,0.182024,0.191626,2589.953968,12,0.000191
n2562,choosing,,choosing,1,1,2,1,1,2,12,0.175662,0.183557,2555,5,0.000143
n2563,initiating,,initiating,1,1,2,1,1,2,11,0.213024,0.227105,2567,5,0.000181
n2564,deciding,,deciding,1,1,2,1,1,2,11,0.18656,0.195955,69.306372,15,0.000165
n2565,executing,,executing,1,1,2,1,1,2,12,0.185108,0.194752,1277.713057,5,0.000163
n2566,behaviors,,behaviors,1,1,2,1,1,2,10,0.204247,0.216037,144.864486,19,0.000155
n2567,causes,,causes,1,1,2,1,1,2,11,0.199953,0.211919,528.334886,23,0.000159
n2568,conflicts,,conflicts,1,1,2,1,1,2,10,0.204247,0.216037,144.864486,19,0.000155
n2569,concluding,,concluding,1,1,2,1,1,2,10,0.218108,0.233606,326.663307,19,0.000152
