Id,Word,Frequency,Module,indegree,outdegree,Degree
n0,practice,89,1,11,1,12
n1,inquiry,418,1,68,1,69
n2,think,72,16,8,1,9
n3,pedagogy,37,15,6,1,7
n4,digital,14,6,2,1,3
n5,age,14,1,2,7,9
n6,opportunity,30,1,5,1,6
n7,reconsider,2,1,0,1,1
n8,basic,20,1,4,1,5
n9,model,139,14,20,1,21
n10,teacher,179,4,30,1,31
n11,learn,306,1,45,1,46
n12,one,35,15,5,1,6
n13,start,23,2,6,1,7
n14,point,32,2,8,16,24
n15,interest,56,14,11,2,13
n16,learner,48,14,10,1,11
n17,category_classify,28,14,7,1,8
n18,dewey,20,1,4,1,5
n19,conversation,10,16,0,1,1
n20,communicate,28,16,5,2,7
n21,find,30,16,6,2,8
n22,thing,20,7,5,1,6
n23,make,86,5,11,1,12
n24,construct,49,13,7,2,9
n25,art,4,6,1,2,3
n26,express,22,16,8,1,9
n27,call,4,8,0,2,2
n28,natural,26,8,5,1,6
n29,resource,12,11,1,6,7
n30,uninvested,2,11,1,1,2
n31,capital,2,11,1,1,2
n32,upon,14,11,3,7,10
n33,depend,4,11,1,2,3
n34,active,34,3,5,1,6
n35,grow,4,3,1,2,3
n36,child,364,3,74,1,75
n37,dewey1956pp4748,2,1,0,1,1
n38,state,32,17,7,1,8
n39,similar,24,6,2,12,14
n40,idea,88,14,14,3,17
n41,process,170,16,18,1,19
n42,form,42,13,9,21,30
n43,stage,28,5,6,14,20
n44,reflective,8,8,3,1,4
n45,action,22,8,3,1,4
n46,definition,9,1,2,1,3
n47,latter,4,11,0,2,2
n48,use,150,14,32,2,34
n49,situation,23,4,4,1,5
n50,provide,44,15,4,3,7
n51,descriptive,4,13,1,2,3
n52,account,8,13,1,4,5
n53,survival,2,13,1,1,2
n54,world,72,8,10,1,11
n55,control,6,12,1,1,2
n56,instruct_guide,18,12,4,1,5
n57,transformation,6,12,1,3,4
n58,indetermine,8,4,2,1,3
n59,determine,4,3,0,2,2
n60,constitute,8,3,4,4,8
n61,distinction,6,9,3,3,6
n62,relation,24,8,7,2,9
n63,convert,2,1,0,1,1
n64,element,12,1,3,1,4
n65,original,6,3,2,3,5
n66,unified,4,10,1,1,2
n67,whole,6,10,1,3,4
n68,inspire,6,13,0,3,3
n69,source,6,1,2,3,5
n70,fundamental,6,1,2,3,5
n71,begin,18,14,2,9,11
n72,spiral,2,1,0,1,1
n73,path,18,1,4,9,13
n74,envisioned,2,5,0,1,1
n75,ask,52,5,12,1,13
n76,question,181,5,29,1,30
n77,investigate,72,11,7,4,11
n78,solution,22,1,5,1,6
n79,create,30,18,2,3,5
n80,discuss,54,10,7,1,8
n81,discover,27,6,4,3,7
n82,experience,153,7,25,2,27
n83,reflect,50,10,9,2,11
n84,new,86,13,20,1,21
n85,knowledge,124,13,17,1,18
n86,follow,19,1,3,10,13
n87,brucebishop2002,2,4,0,1,1
n88,phase,66,4,21,1,22
n89,leadership,30,3,4,1,5
n90,next,12,1,3,1,4
n91,authentic,14,7,2,1,3
n92,teachable,2,5,0,1,1
n93,moment,4,5,1,2,3
n94,explore,125,3,26,1,27
n95,turn,4,14,0,2,2
n96,brucedavidson1996,2,10,0,1,1
n97,solve,36,6,3,1,4
n98,problem,81,6,19,1,20
n99,reformulating,2,6,0,1,1
n100,posing,4,13,0,2,2
n101,close,4,6,0,2,2
n102,tied,2,6,1,1,2
n103,dialogue,11,6,2,1,3
n104,others,30,6,8,15,23
n105,cycle,48,1,3,1,4
n106,present,20,1,6,10,16
n107,aspect,24,1,5,1,6
n108,need,32,3,9,16,25
n109,support,61,3,12,1,13
n110,success,10,3,3,1,4
n111,environment,36,3,3,1,4
n112,serve,8,12,0,1,1
n113,boundary,2,13,0,1,1
n114,object,42,13,8,4,12
n115,stargriesmer1989,2,12,0,1,1
n116,allow,32,12,5,1,6
n117,us,13,1,2,1,3
n118,relate,30,13,2,1,3
n119,theory,37,14,5,18,23
n120,ordinary,2,14,1,1,2
n121,look,16,7,3,1,4
n122,across,16,6,6,1,7
n123,modes,4,16,0,2,2
n124,context,42,4,8,2,10
n125,inform,8,1,2,4,6
n126,guide,82,1,16,1,17
n127,education,86,4,11,2,13
n128,important,36,2,11,2,13
n129,note,6,18,1,3,4
n130,merely,4,18,1,2,3
n131,suggestive,2,18,1,1,2
n132,neither,4,18,1,2,3
n133,sole,4,18,1,2,3
n134,complete,4,18,2,2,4
n135,rigid,2,18,1,1,2
n136,characterization,2,18,1,1,2
n137,actual,10,19,3,5,8
n138,rarely,2,7,0,1,1
n139,proceeds,4,7,1,2,3
n140,simple,26,5,5,1,6
n141,linear,8,20,2,4,6
n142,fashion,2,5,1,1,2
n143,five,10,5,1,5,6
n144,dimension,36,1,4,1,5
n145,overlap,2,8,0,1,1
n146,every,14,8,3,7,10
n147,give,24,3,8,1,9
n148,embed,8,6,1,4,5
n149,fact,16,13,5,8,13
n150,nature,14,1,5,2,7
n151,mutual,4,20,0,2,2
n152,reinforce,8,20,3,4,7
n153,interrelated,2,20,1,1,2
n154,despite,4,20,2,2,4
n155,complexity,6,1,3,3,6
n156,highlights,4,1,0,2,2
n157,otherwise,2,16,0,1,1
n158,opaque,2,16,1,1,2
n159,reminds,8,4,2,2,4
n160,develop,119,2,22,1,23
n161,arise,14,3,3,7,10
n162,meaning,42,4,9,1,10
n163,genuine,4,14,2,1,3
n164,reallife,4,7,0,1,1
n165,challenge,24,5,5,1,6
n166,refer,14,13,3,7,10
n167,part,18,1,3,1,4
n168,include,50,6,12,1,13
n169,individual,12,8,3,1,4
n170,participate,42,14,5,1,6
n171,community,22,18,3,1,4
n172,something,8,17,2,4,6
n173,delivered,4,17,1,2,3
n174,outside,2,17,1,1,2
n175,example,12,3,2,6,8
n176,come,14,3,4,7,11
n177,early,81,4,16,1,17
n178,study,58,4,16,1,17
n179,computer,12,12,1,6,7
n180,researcher,8,18,2,4,6
n181,found,10,3,2,5,7
n182,student,174,12,31,1,32
n183,become,22,14,2,1,3
n184,engage,84,3,15,1,16
n185,bug,4,12,1,2,3
n186,software,4,14,1,2,3
n187,behavior,8,13,1,4,5
n188,deep,9,6,2,5,7
n189,programming,2,18,0,1,1
n190,enormous,2,18,1,1,2
n191,different,36,6,8,1,9
n192,answer,20,5,4,1,5
n193,someone,2,5,0,1,1
n194,elses,2,5,1,1,2
n195,formulate,16,13,1,1,2
n196,oldsschwartzwillie1980p40,2,2,0,1,1
n197,caution,4,4,1,2,3
n198,always,8,12,1,4,5
n199,well,24,6,5,12,17
n200,articulate,12,5,4,6,10
n201,elspethhuxley1959,2,17,1,1,2
n202,best,10,6,4,5,9
n203,way,42,16,12,3,15
n204,fire,2,5,0,1,1
n205,like,14,9,1,1,2
n206,firing,2,11,0,1,1
n207,gun,4,11,2,2,4
n208,bang,2,11,1,1,2
n209,goes,2,11,1,1,2
n210,everything,2,11,1,1,2
n211,take,38,12,10,1,11
n212,flight,2,7,0,1,1
n213,runs,2,7,1,1,2
n214,shelter,2,7,1,1,2
n215,sit,2,7,1,1,2
n216,quite,4,7,1,2,3
n217,still,8,7,2,4,6
n218,play,40,3,7,1,8
n219,little,4,9,1,2,3
n220,will,24,13,5,1,6
n221,peck,2,4,1,1,2
n222,round,2,4,1,1,2
n223,feet,2,4,1,1,2
n224,venture,2,15,0,1,1
n225,forth,2,15,1,1,2
n226,thickets,2,15,1,1,2
n227,intent,10,15,3,2,5
n228,creep,2,7,0,1,1
n229,sun,2,7,1,1,2
n230,stone,2,7,1,1,2
n231,patient,4,7,2,2,4
n232,see,28,7,4,1,5
n233,understand,125,1,23,1,24
n234,great,10,2,1,5,6
n235,deal,8,2,1,4,5
n236,man,2,11,1,1,2
n237,p272,2,11,1,1,2
n238,variety,4,7,1,1,2
n239,possible,14,16,4,7,11
n240,many,17,16,7,9,16
n241,suggests,12,5,2,6,8
n242,require,4,2,1,2,3
n243,diverse,4,2,1,2,3
n244,material,36,8,6,1,7
n245,interaction,52,1,12,1,13
n246,moral,2,6,1,1,2
n247,physical,16,6,3,1,4
n248,emotional,4,6,1,2,3
n249,aesthetic,4,6,2,2,4
n250,practical,4,1,2,2,4
n251,inherent,6,1,0,3,3
n252,enhance,12,10,4,6,10
n253,addons,2,10,1,1,2
n254,gather,16,13,2,1,3
n255,information,21,13,4,10,14
n256,craft,2,5,0,1,1
n257,experiment,24,5,4,12,16
n258,observe,32,11,7,1,8
n259,interview,4,8,1,2,3
n260,recast,2,5,0,1,1
n261,refine,12,18,2,1,3
n262,line,4,1,1,2,3
n263,query,6,4,2,1,3
n264,plunge,2,13,0,1,1
n265,anticipate,2,13,0,1,1
n266,selfmotivated,2,16,0,1,1
n267,owned,2,3,0,1,1
n268,picks,2,12,0,1,1
n269,term,22,8,4,12,16
n270,means,12,3,3,6,9
n271,handson,16,7,2,2,4
n272,imply,6,4,1,3,4
n273,creation,2,4,0,1,1
n274,collaborative,32,16,5,2,7
n275,role,28,4,5,1,6
n276,coalesce,2,14,1,1,2
n277,connect,20,16,4,10,14
n278,ability,16,16,1,8,9
n279,synthesize,2,4,1,1,2
n280,creative,10,16,2,5,7
n281,spark,2,16,1,1,2
n282,now,10,16,0,5,5
n283,undertakes,2,16,1,1,2
n284,task,28,8,9,2,11
n285,shape,10,20,1,1,2
n286,significant,6,4,0,3,3
n287,thought,12,5,3,1,4
n288,extend,18,14,3,9,12
n289,hisher,4,13,1,2,3
n290,previous,38,13,6,1,7
n291,implicit,4,1,1,2,3
n292,personal,8,7,2,1,3
n293,social,26,8,4,1,5
n294,arrangements,2,18,0,1,1
n295,involve,44,11,6,2,8
n296,listen,8,6,2,4,6
n297,enterprise,8,1,1,1,2
n298,share,34,18,6,5,11
n299,built,28,11,6,2,8
n300,relevance,10,4,2,5,7
n301,society,2,14,0,1,1
n302,compare,14,3,4,1,5
n303,conclusion,23,16,4,1,5
n304,multiple,10,1,1,5,6
n305,media,13,6,3,1,4
n306,online,4,16,1,2,3
n307,networks,2,10,0,1,1
n308,tell,2,1,0,1,1
n309,recognise,12,3,2,6,8
n310,say,10,2,4,5,9
n311,whether,4,10,1,2,3
n312,transform,4,10,1,2,3
n313,later,8,12,1,4,5
n314,work,37,5,8,1,9
n315,schÂ¨on1987,2,6,0,1,1
n316,thereby,2,5,0,1,1
n317,able,10,5,2,5,7
n318,move,14,12,4,2,6
n319,concept,131,2,21,1,22
n320,indeterminacies,2,3,1,1,2
n321,continue,12,20,2,6,8
n322,time,29,7,8,14,22
n323,back,4,12,0,2,2
n324,initial,13,10,2,1,3
n325,research,30,4,7,2,9
n326,made,18,15,2,1,3
n327,inventory,2,5,0,1,1
n328,observation,82,5,9,1,10
n329,decision,6,1,1,3,4
n330,light,6,15,1,3,4
n331,might,10,7,1,5,6
n332,circle,4,7,1,2,3
n333,structure,52,6,8,1,9
n334,whereby,6,20,1,3,4
n335,pupils,18,1,6,1,7
n336,design,52,15,10,3,13
n337,class,16,10,4,1,5
n338,activity,105,7,15,1,16
n339,conditions,8,1,1,4,5
n340,left,2,1,0,1,1
n341,unsupported,4,1,1,2,3
n342,draw,21,16,5,1,6
n343,manage,6,12,1,3,4
n344,impuls,2,1,0,1,1
n345,toward,8,1,2,4,6
n346,project,18,1,7,9,16
n347,goal,26,18,7,3,10
n348,often,26,8,4,13,17
n349,classroom,32,18,7,1,8
n350,sometimes,2,13,0,1,1
n351,seek,10,13,3,5,8
n352,arouse,4,13,1,2,3
n353,times,10,6,3,5,8
n354,specify,5,8,3,2,5
n355,within,44,1,12,4,16
n356,group,20,3,4,1,5
n357,encourage,29,3,3,1,4
n358,function,16,19,6,8,14
n359,scaffold,18,8,5,1,6
n360,primary,24,4,3,1,4
n361,ahead,2,15,0,1,1
n362,signature,6,15,1,1,2
n363,sharply,2,1,0,1,1
n364,define,12,1,2,6,8
n365,instead,8,1,2,4,6
n366,set,46,7,8,23,31
n367,open,32,11,7,1,8
n368,end,16,11,1,2,3
n369,authors,8,14,1,4,5
n370,argue,22,14,4,2,6
n371,general,19,4,3,10,13
n372,product,25,18,3,1,4
n373,literacy,12,16,0,6,6
n374,unlike,4,3,1,2,3
n375,empirical,26,14,4,1,5
n376,result,43,16,7,1,8
n377,alone,6,11,2,3,5
n378,theoretical,16,14,5,1,6
n379,analyse,38,5,7,1,8
n380,removed,2,1,0,1,1
n381,sense,28,14,6,1,7
n382,know,36,16,4,18,22
n383,attend,2,12,1,1,2
n384,wide,4,7,1,2,3
n385,range,6,7,2,3,5
n386,show,20,3,2,10,12
n387,value,6,12,2,3,5
n388,center,22,4,2,11,13
n389,orient,12,4,2,6,8
n390,powerful,8,15,0,4,4
n391,live_habitat,8,1,1,1,2
n392,report,20,10,8,1,9
n393,detail,6,1,1,3,4
n394,employ,12,14,2,1,3
n395,soundness,2,1,0,1,1
n396,viability,2,1,1,1,2
n397,enriched,6,1,0,3,3
n398,enable,18,3,2,1,3
n399,offering,2,13,0,1,1
n400,entry,6,2,0,1,1
n401,picture,5,11,1,2,3
n402,facilitate,14,3,3,1,4
n403,sustain,4,14,0,2,2
n404,expand,8,13,3,4,7
n405,review,6,18,0,3,3
n406,outputs,2,11,1,1,2
n407,story,4,11,2,2,4
n408,web,6,13,2,3,5
n409,site,1,13,1,0,1
n410,school,16,7,4,8,12
n411,university,4,17,2,2,4
n412,partner,6,17,2,3,5
n413,sought,2,17,1,1,2
n414,science,526,1,102,1,103
n415,formal,4,1,1,2,3
n416,introduce,20,3,5,1,6
n417,infer,12,16,1,6,7
n418,evidence,67,14,15,2,17
n419,qualitative,4,4,1,2,3
n420,quantitative,2,4,1,1,2
n421,data,88,5,14,1,15
n422,confirm,17,13,3,1,4
n423,derived,4,7,0,2,2
n424,logical,12,16,2,1,3
n425,interpret,34,5,6,1,7
n426,based,46,5,5,1,6
n427,young,66,3,15,1,16
n428,attain,2,1,0,1,1
n429,specific,36,1,3,1,4
n430,strategy,8,10,0,4,4
n431,attainment,2,10,1,1,2
n432,akersonvolrich2006,2,10,1,1,2
n433,khishfeabdelkhalick2002,2,10,1,1,2
n434,metz2004,5,10,1,2,3
n435,throughout,8,5,1,4,5
n436,documents,2,5,1,1,2
n437,scientist,18,1,1,9,10
n438,done,8,1,2,4,6
n439,repeat,6,10,2,3,5
n440,increase,8,10,2,4,6
n441,level,28,10,6,2,8
n442,proficient,12,13,1,6,7
n443,bybee2011,2,10,1,1,2
n444,michaelsetal2008,2,10,1,1,2
n445,crosscutting,4,2,1,1,2
n446,disciplinary,2,14,0,1,1
n447,engineering,6,6,1,3,4
n448,worldview,2,6,1,1,2
n449,nrc2012p42,1,6,1,0,1
n450,good,5,16,2,3,5
n451,frame,14,3,1,7,8
n452,anderson2002,6,1,1,3,4
n453,framework,14,1,3,7,10
n454,instruction,66,14,7,1,8
n455,und,2,14,0,1,1
n456,evaluate,37,14,6,2,8
n457,furtaketal2012,7,6,0,4,4
n458,suggest,18,16,5,9,14
n459,two,12,1,5,1,6
n460,cognitive,38,18,8,2,10
n461,regard,19,8,6,1,7
n462,minneretal2009,2,16,0,1,1
n463,p20,2,11,0,1,1
n464,consistent,5,11,3,2,5
n465,duschl2008,4,11,1,2,3
n466,identify,20,14,3,1,4
n467,epistemic,20,15,2,1,3
n468,domain,20,6,3,1,4
n469,principle,12,15,2,6,8
n470,consist,16,5,1,1,2
n471,generate,26,5,3,2,5
n472,comprise,6,5,0,3,3
n473,realize,2,1,0,1,1
n474,curriculum,34,2,7,2,9
n475,instance,4,6,1,2,3
n476,ibse,3,6,0,2,2
n477,commonly,6,6,3,3,6
n478,according,18,13,5,10,15
n479,degree,8,1,3,1,4
n480,free,12,3,1,1,2
n481,operate,6,14,0,3,3
n482,belletal2005,2,4,0,1,1
n483,accompanied,6,4,3,3,6
n484,debate,4,4,2,2,4
n485,effect,26,14,8,1,9
n486,minimally,2,1,0,1,1
n487,versus,2,1,0,1,1
n488,hmelosilveretal2007,6,12,2,3,5
n489,kirschneretal2006,4,12,1,2,3
n490,typical,11,12,2,1,3
n491,ie,10,7,1,5,6
n492,however,28,4,5,14,19
n493,peers,8,9,1,4,5
n494,high,12,10,2,2,4
n495,particular,19,2,4,10,14
n496,fostering,4,12,0,2,2
n497,subject,6,14,1,1,2
n498,matter,8,14,1,1,2
n499,complex,14,6,2,2,4
n500,limit,10,6,3,5,8
n501,hardyetal2006,4,6,2,2,4
n502,large,4,13,2,2,4
n503,body,8,13,3,1,4
n504,far,2,1,0,1,1
n505,propose,10,14,4,5,9
n506,treagustduit2008,2,4,1,1,2
n507,reach,10,13,1,5,6
n508,consider,18,16,3,1,4
n509,slow,2,16,0,1,1
n510,gradual,2,16,1,1,2
n511,rather,10,2,1,5,6
n512,dramatic,4,2,2,2,4
n513,gestalttype,2,2,1,1,2
n514,shift,4,3,2,2,4
n515,paradigms,2,3,1,1,2
n516,caravitahallden1994,2,3,1,1,2
n517,spontaneous,4,6,0,2,2
n518,explanation,66,13,11,3,14
n519,phenomenon,23,7,2,12,14
n520,daily,6,7,1,3,4
n521,life,14,7,3,1,4
n522,carey2000,2,1,0,1,1
n523,view,14,3,4,1,5
n524,preinstructional,2,2,0,1,1
n525,partially,2,8,1,1,2
n526,entirely,2,8,1,1,2
n527,inadequate,2,8,1,1,2
n528,furthermore,6,8,1,3,4
n529,place,26,12,6,1,7
n530,demands,2,12,0,1,1
n531,language,28,13,7,1,8
n532,summarize,8,1,1,5,6
n533,oral,4,13,2,1,3
n534,write,10,13,2,5,7
n535,leefradd1998,2,13,1,1,2
n536,sufficient,6,13,2,3,5
n537,explain,26,14,3,1,4
n538,akersonetal2000,2,13,0,1,1
n539,osborneetal2004,2,13,1,1,2
n540,van,2,13,1,1,2
n541,boxteletal2000,2,13,1,1,2
n542,skill,98,16,15,1,16
n543,tractable,2,9,0,1,1
n544,difficult,6,9,2,3,5
n545,add,14,12,6,1,7
n546,poor,2,13,0,1,1
n547,hence,4,12,1,2,3
n548,especially,6,12,2,3,5
n549,beneficial,2,12,1,1,2
n550,risk,6,10,1,3,4
n551,achieve,6,8,3,3,6
n552,lamainalapates,3,2,1,2,3
n553,program,14,1,5,7,12
n554,advocates,4,1,2,2,4
n555,incites,2,3,0,1,1
n556,around,26,8,2,1,3
n557,acquire,14,1,3,7,10
n558,content,31,13,5,1,6
n559,reason,4,7,1,2,3
n560,master,4,7,1,2,3
n561,french,1,1,0,1,1
n562,shares,4,1,1,2,3
n563,broad,10,1,3,5,8
n564,main,6,18,1,3,4
n565,contribute,4,2,0,2,2
n566,critical,24,16,2,1,3
n567,thinking,32,16,4,1,5
n568,lamainalapates2000,2,2,0,1,1
n569,saltiel2006,2,2,1,1,2
n570,sarmantetal2011,2,2,1,1,2
n571,promote,10,2,3,5,8
n572,expected,12,13,1,6,7
n573,carry,16,5,2,1,3
n574,raise,8,5,2,4,6
n575,vital,10,3,2,5,7
n576,influence,10,19,3,5,8
n577,5e,32,14,7,1,8
n578,bybeeetal2006,10,15,1,5,6
n579,biological,8,1,2,1,3
n580,get,8,7,1,4,5
n581,sequence,16,7,4,1,5
n582,atkinskarplus1962,4,3,0,2,2
n583,formation,2,13,0,1,1
n584,extension,2,13,1,1,2
n585,3e,2,1,0,1,1
n586,piagets,4,19,1,2,3
n587,mental,6,19,2,3,5
n588,marek2008,2,14,0,1,1
n589,establish,8,6,1,4,5
n590,constructivism,10,14,3,5,8
n591,approach,40,3,9,2,11
n592,assume,10,14,2,1,3
n593,bring,6,14,2,3,5
n594,test,14,13,4,7,11
n595,exist,10,13,2,5,7
n596,real,20,8,6,1,7
n597,family,8,2,2,4,6
n598,easy,6,2,1,3,4
n599,assimilated,2,2,1,1,2
n600,accommodation,2,14,0,1,1
n601,fit,8,14,3,1,4
n602,unfamiliar,6,9,1,3,4
n603,colburn2003,2,14,1,1,2
n604,researchbased,2,14,1,1,2
n605,incorporate,13,3,2,7,9
n606,notion,10,3,3,5,8
n607,cooperation,2,7,1,1,2
n608,coconstruct,10,14,1,1,2
n609,essential,10,3,1,1,2
n610,itemized,2,20,0,1,1
n611,manner,6,20,2,3,5
n612,guest,2,20,1,1,2
n613,editorial,2,20,1,1,2
n614,bybee2014,2,20,1,1,2
n615,respond,6,5,0,1,1
n616,recommend,14,4,5,7,12
n617,enumerates,2,9,1,1,2
n618,implications,2,9,1,1,2
n619,usage,2,9,1,1,2
n620,application,6,9,3,3,6
n621,era,2,9,1,1,2
n622,generation,6,1,1,1,2
n623,standard,14,3,0,7,7
n624,ngss2013,2,3,1,1,2
n625,preferable,2,4,1,1,2
n626,timeframe,2,4,1,1,2
n627,longterm,8,4,1,4,5
n628,period,8,2,1,4,5
n629,unit,13,5,2,6,8
n630,spanning,2,5,0,1,1
n631,2â3,2,5,1,1,2
n632,week,6,5,3,3,6
n633,lose,6,2,2,3,5
n634,bybee,2,4,1,1,2
n635,omitting,2,4,1,1,2
n636,nrc1999,2,15,1,1,2
n637,rearranging,2,15,1,1,2
n638,renner,2,16,0,1,1
n639,abrahambernie1988,2,16,1,1,2
n640,integrity,2,1,0,1,1
n641,seem,9,7,1,5,6
n642,inflexible,2,7,0,1,1
n643,suitable,4,7,2,2,4
n644,childhood,42,4,1,2,3
n645,repetition,2,4,0,1,1
n646,chance,6,7,1,3,4
n647,flexibility,4,12,1,2,3
n648,prerequisite,4,13,0,2,2
n649,deem,2,4,1,1,2
n650,necessary,8,4,2,4,6
n651,grade,6,4,0,3,3
n652,yoononchwari2006,2,4,1,1,2
n653,kindergartener,50,9,10,1,11
n654,fledgling,2,7,1,1,2
n655,milleretal2013,2,7,1,1,2
n656,last,4,7,2,2,4
n657,century,2,7,1,1,2
n658,investigative,10,5,1,1,2
n659,competence,2,1,0,1,1
n660,compatible,2,3,0,1,1
n662,integrate,11,13,2,6,8
n663,nsta2014,2,17,0,1,1
n664,position,6,17,2,1,3
n665,declares,2,2,0,1,1
n666,educators,10,3,2,5,7
n667,nurture,2,3,1,1,2
n668,focus,42,3,9,1,10
n669,ngssleadstates2013,2,3,1,1,2
n670,academic,4,17,0,2,2
n671,modify,10,14,2,5,7
n672,version,8,14,3,4,7
n673,method,31,14,2,2,4
n674,course,6,4,2,3,5
n675,midwest,4,4,2,2,4
n676,united,10,17,2,1,3
n677,20,2,3,0,1,1
n678,4year,2,3,0,1,1
n679,old,6,3,3,1,4
n680,taught,10,4,3,5,8
n681,preservice,10,4,1,1,2
n682,enrolled,2,4,0,1,1
n683,major,4,7,1,2,3
n684,field,8,7,2,1,3
n685,requirement,2,4,0,1,1
n686,lesson,16,9,4,2,6
n687,plan,22,9,4,1,5
n688,adult,26,9,9,13,22
n689,assign,6,9,1,3,4
n690,voluntary,2,12,0,1,1
n691,first,10,12,2,5,7
n692,outdoor,8,7,1,1,2
n693,acreage,2,15,1,1,2
n694,frequent,8,11,3,1,4
n695,climbing,2,6,0,1,1
n696,logs,2,6,1,1,2
n697,wood,4,6,2,2,4
n698,grounded,6,1,1,3,4
n699,dam,2,6,0,1,1
n700,ditch,2,6,0,1,1
n701,piece,2,6,1,1,2
n702,chasing,2,6,1,1,2
n703,frog,2,6,1,1,2
n704,space,4,6,0,2,2
n705,crevice,2,8,1,1,2
n706,spiders,2,3,0,1,1
n707,excited,2,7,0,1,1
n708,independent,4,11,1,2,3
n709,session,3,7,0,2,2
n710,topic,13,3,1,6,7
n711,plant,10,9,5,1,6
n712,animal,8,9,2,4,6
n713,characteristic,6,1,3,3,6
n714,habitat,2,2,1,1,2
n715,landscape,4,15,1,2,3
n716,attribute,4,15,1,2,3
n717,robust,4,13,1,2,3
n718,namely,2,5,1,1,2
n719,elaborate,16,14,4,1,5
n720,describe_ption,19,16,6,2,8
n721,purpose,12,4,1,1,2
n722,text,6,9,1,3,4
n723,perceive,4,3,0,2,2
n724,cultureâhistorical,2,3,1,1,2
n725,viewpoint,2,3,1,1,2
n726,section,3,12,2,0,2
n727,trundleetal2010,2,13,0,1,1
n728,contemporary,4,1,1,2,3
n729,intuitive,8,4,0,1,1
n730,gopnik2012,2,5,0,1,1
n731,study_teacher,2,9,0,1,1
n732,provocateur,6,12,1,1,2
n733,wien2014,2,13,0,1,1
n734,central,14,14,3,7,10
n735,tenets,6,14,2,1,3
n736,reformbased,2,4,0,1,1
n737,bransfordetal2000,2,1,0,1,1
n738,small,9,3,1,1,2
n739,krajciketal2003,2,17,0,1,1
n740,2014,2,17,1,1,2
n741,national,10,4,3,2,5
n742,associate,10,1,0,1,1
n743,nsta,2,3,0,1,1
n744,stressed,2,3,1,1,2
n745,order,22,10,6,1,7
n746,strengthen,4,12,0,2,2
n747,council,2,4,0,1,1
n748,nrc20072012,2,4,0,1,1
n749,drive,6,1,0,3,3
n750,conduct,12,11,0,1,1
n751,appropriate,26,15,5,1,6
n752,tool,22,15,3,2,5
n753,equipment,2,1,0,1,1
n754,nsta2004a,2,6,1,1,2
n755,crucial,2,6,1,1,2
n756,component,8,1,2,4,6
n757,read,4,9,1,2,3
n758,faced,4,5,0,2,2
n759,alternative,12,16,3,2,5
n760,representation,12,13,2,6,8
n761,visible,2,6,0,1,1
n762,various,4,13,0,2,2
n763,visual,2,6,1,1,2
n764,collect,30,5,3,1,4
n765,promising,2,3,0,1,1
n766,help,18,3,4,1,5
n767,predict,52,9,9,3,12
n770,overall,5,15,1,1,2
n771,sparks,4,14,0,1,1
n772,anchors,4,14,1,1,2
n773,want,10,16,2,1,3
n774,adaptable,8,15,1,1,2
n775,represent,12,1,2,1,3
n776,emerge,22,1,5,3,8
n777,accurate,4,14,1,1,2
n778,inaccurate,4,14,1,1,2
n779,critiqued,4,18,1,1,2
n780,key,29,1,8,3,11
n781,lpp,10,14,1,1,2
n782,system,10,14,3,1,4
n783,1,17,5,3,1,4
n784,augmented,4,8,0,1,1
n785,vision,2,12,1,1,2
n786,record,20,5,2,3,5
n787,display,6,1,1,3,4
n788,location,6,9,0,3,3
n789,2,16,9,3,8,11
n790,translate,4,14,2,2,4
n791,motion,14,14,3,1,4
n792,physics,8,2,0,1,1
n793,engine,2,5,0,1,1
n794,sensing,2,5,0,1,1
n795,commercially,2,11,0,1,1
n796,available,2,11,1,1,2
n797,track_trace,4,14,1,2,3
n798,pattern,12,14,2,6,8
n799,technology,8,18,1,4,5
n800,kato2006,2,18,1,1,2
n801,inexpensive,2,16,0,1,1
n802,virtual,2,8,0,1,1
n803,12,4,18,1,2,3
n804,x,2,18,1,1,2
n805,carpet,2,18,1,1,2
n806,front,2,18,1,1,2
n807,instantly,2,13,0,1,1
n808,imported,2,13,1,1,2
n809,microworld,2,12,1,1,2
n810,force,4,7,1,2,3
n811,simulation,7,5,2,3,5
n812,animation,2,12,1,1,2
n813,combine,8,12,1,4,5
n814,symbol,2,1,0,1,1
n815,marked,2,2,0,1,1
n816,embodied,4,2,1,2,3
n817,net,2,7,0,1,1
n818,game,2,7,1,1,2
n819,6â8,2,12,1,1,2
n820,year,16,12,2,8,10
n821,interrogate,2,1,0,1,1
n822,roseberyetal2005,2,3,0,1,1
n823,danish2009,2,14,0,1,1
n824,skits,2,2,1,1,2
n825,enact,4,13,0,2,2
n826,leverage,2,13,0,1,1
n827,kind,14,9,4,7,11
n828,colella2000,2,3,1,1,2
n829,try,20,7,2,1,3
n830,desired,2,4,0,1,1
n831,resultand,2,4,1,1,2
n832,affect,2,4,1,1,2
n833,type,12,13,4,1,5
n834,explicit,6,10,1,3,4
n835,rules,2,5,0,1,1
n836,underlie,2,5,1,1,2
n837,multi,4,12,0,2,2
n838,faceted,2,12,1,1,2
n839,aim,14,3,5,1,6
n840,choice,6,1,1,3,4
n841,change,8,13,0,4,4
n842,water,10,13,4,5,9
n843,single,8,7,3,4,7
n844,garritz2012,2,4,0,1,1
n845,newmanetal2004,2,4,1,1,2
n846,characterized,4,4,1,2,3
n847,progression,10,3,0,5,5
n848,already,4,16,2,1,3
n849,interacademy,2,15,0,1,1
n850,partnership,2,15,1,1,2
n851,iap2010p19,2,15,1,1,2
n852,among,6,15,1,3,4
n853,perspective,8,1,2,4,6
n854,requires,8,16,0,4,4
n855,caamano2012,2,1,0,1,1
n856,criadogarcÃ­acarmona2011,2,1,1,1,2
n857,harlen2014,3,1,1,1,2
n858,score2013,2,13,0,1,1
n859,hodson2014,2,2,0,1,1
n860,exa,2,2,1,1,2
n861,agree,6,1,3,1,4
n862,ledermanetal2014,2,1,1,1,2
n863,hypothesis,46,13,12,1,13
n864,ii,4,7,0,2,2
n865,iii,4,1,0,2,2
n866,pose,8,4,0,4,4
n867,iv,2,6,1,1,2
n868,v,2,1,0,1,1
n869,vi,2,16,0,1,1
n870,must,8,11,0,4,4
n871,vii,2,1,1,1,2
n872,number,8,16,2,4,6
n873,image,2,1,0,1,1
n874,etc,2,1,1,1,2
n875,viii,2,13,0,1,1
n876,mentioned,2,7,1,1,2
n877,even,9,4,1,5,6
n878,tentative,2,1,0,1,1
n879,three,17,8,2,2,4
n880,distinguish,4,9,1,2,3
n881,guisasolaetal2006,2,13,1,1,2
n882,stating,2,17,0,1,1
n883,yet,8,17,3,4,7
n884,event,6,5,1,3,4
n885,speculating,2,7,0,1,1
n886,deductive,2,16,0,1,1
n887,trueprocedural,2,13,0,1,1
n888,measurement,14,5,2,7,9
n889,procedure,20,5,3,1,4
n890,indicate,4,12,0,2,2
n891,obtain,12,7,1,1,2
n892,beforehand,2,10,1,1,2
n893,either,8,7,0,1,1
n894,organization,4,1,2,2,4
n895,fsls,1,18,0,1,1
n896,ultimate,4,18,2,1,3
n897,fsl,4,8,0,2,2
n898,openfocused,4,3,0,1,1
n899,engageâexploreâreflect,2,1,1,1,2
n900,eer,6,1,1,1,2
n901,talk,12,1,3,6,9
n902,tips,2,1,1,1,2
n903,depicted,2,5,0,1,1
n904,figure,6,5,3,1,4
n905,illustrate,4,1,1,2,3
n906,iterative,4,16,0,2,2
n907,stepbystep,4,20,1,2,3
n908,spiraling,2,15,0,1,1
n909,dynamic,4,15,2,2,4
n910,integrates,2,1,1,1,2
n911,unstructured,2,3,0,1,1
n912,jumpstarting,2,13,1,1,2
n913,b,8,6,0,4,4
n914,responsive,2,3,0,1,1
n915,simplified,2,14,0,1,1
n916,cycles,2,16,1,1,2
n917,contextualizes,2,1,0,1,1
n918,efforts,2,16,0,1,1
n919,invite,2,9,0,1,1
n920,explicated,2,12,0,1,1
n921,upcoming,2,12,1,1,2
n922,area,8,7,2,4,6
n923,menmuiradams1997processes,2,7,1,1,2
n924,inconjunction,2,1,0,1,1
n925,mathematical,37,1,6,1,7
n926,epstein2007,4,9,0,2,2
n927,french2004,9,9,2,1,3
n928,gerdeetal2013,10,9,2,5,7
n929,menmuiradams1997,2,9,1,1,2
n930,afford,2,9,0,1,1
n931,fascination,4,19,1,2,3
n932,rich,4,13,0,2,2
n933,just,16,1,5,8,13
n934,static,4,13,2,2,4
n935,prescribed,6,13,1,3,4
n936,big,6,14,2,1,3
n937,gelmanbrenneman2012,4,9,1,2,3
n938,wasserman2015,2,9,1,1,2
n939,gelmanetal2010,2,9,0,1,1
n940,greenfieldetal2009,5,9,3,2,5
n941,inanetal2010,7,9,2,4,6
n942,apply,12,15,2,1,3
n943,gelmanbrenneman2004,2,16,0,1,1
n944,linking,4,6,1,2,3
n945,extant,2,6,1,1,2
n946,bjorklund2011,2,9,0,1,1
n947,paper,5,1,1,3,4
n948,case,6,4,2,1,3
n949,implement,4,8,0,2,2
n950,forensic,2,8,1,1,2
n951,fouryearold,4,18,0,2,2
n952,participant,11,1,0,1,1
n953,platform,6,17,1,3,4
n954,prepare,4,4,0,2,2
n955,hackling2007,4,1,1,2,3
n956,manipulation,8,8,2,1,3
n957,gain,14,13,2,7,9
n958,heart,4,1,1,2,3
n959,crawford2009,2,3,0,1,1
n960,excitement,2,6,0,1,1
n961,crawford2007,4,1,1,2,3
n962,appears,4,6,1,2,3
n963,hackling2005,4,1,1,1,2
n964,hedges2000,2,4,0,1,1
n965,acknowledge,8,8,1,1,2
n966,agents,2,16,0,1,1
n967,hedges2000p18,2,15,0,1,1
n968,issue,6,8,1,3,4
n969,select,14,5,4,1,5
n970,samarapungavanetal2008,10,9,2,5,7
n971,commented,2,14,1,1,2
n972,universal,2,7,0,1,1
n973,novices,2,7,1,1,2
n974,p903,2,7,1,1,2
n975,lacking,2,7,1,1,2
n976,discipline,6,6,1,3,4
n977,discourse,30,13,8,1,9
n978,assisting,8,3,1,1,2
n979,better,10,1,2,1,3
n980,outcome,6,4,0,3,3
n981,examine,16,9,5,1,6
n982,kindergarten,14,12,2,2,4
n983,monarch,2,16,0,1,1
n984,butterfly,2,16,1,1,2
n985,revise,12,14,3,6,9
n986,portfolios,2,3,0,1,1
n987,peterson,2,9,0,1,1
n988,french2008,2,9,1,1,2
n989,color,2,5,1,1,2
n990,mixing,2,5,1,1,2
n991,investigators,4,15,0,2,2
n992,demonstrate,4,3,1,2,3
n993,literate,6,6,1,3,4
n994,curious,4,7,1,2,3
n995,surround,5,7,0,2,2
n996,concrete,6,7,0,3,3
n998,cepnietal2006,2,16,1,1,2
n999,divided,2,8,0,1,1
n1000,cause,4,12,0,2,2
n1001,since,2,11,1,1,2
n1002,birth,2,11,1,1,2
n1003,estimation,2,14,0,1,1
n1004,howejones1998,2,13,0,1,1
n1005,check,2,16,0,1,1
n1006,lind2000,2,2,1,1,2
n1007,kefietal2013,2,16,1,1,2
n1008,without,4,2,1,2,3
n1009,sip,1,1,0,1,1
n1010,basis,16,15,2,1,3
n1011,correspond,6,14,2,1,3
n1012,hacking19921995,2,19,0,1,1
n1013,map,4,19,2,2,4
n1014,laboratory,4,19,2,2,4
n1015,subjecting,2,1,1,1,2
n1016,systematic,8,1,3,4,7
n1017,bottomup,2,5,1,1,2
n1018,entity,8,7,2,1,3
n1019,internal,4,7,1,1,2
n1020,hackings,2,1,0,1,1
n1021,psillos,2,16,1,1,2
n1022,tselfes,2,16,1,1,2
n1023,kariotoglou2004,2,16,1,1,2
n1024,peters2006,2,5,0,1,1
n1025,improve,4,1,0,1,1
n1026,hogan2000,4,14,0,1,1
n1027,hoganmaglienti2001,4,14,1,2,3
n1028,deboo2000,2,7,1,1,2
n1029,lind1999,7,7,3,3,6
n1030,novak1977,2,7,1,1,2
n1031,overwhelmingly,4,9,1,2,3
n1032,nses,6,3,2,3,5
n1033,american,2,3,1,1,2
n1034,council1996,2,1,0,1,1
n1035,bredekampcopple1997,2,3,0,1,1
n1036,enactment,9,11,3,1,4
n1037,techniques,4,5,0,2,2
n1038,coordination,2,14,0,1,1
n1039,rely,4,9,1,2,3
n1040,tend,4,11,1,2,3
n1041,mind,2,11,1,1,2
n1042,speak,4,11,1,2,3
n1043,emphasize,19,12,3,10,13
n1044,eshachfried2005,4,17,1,2,3
n1045,harlen1996,2,14,0,1,1
n1046,lind,2,14,1,1,2
n1047,nses1996,1,7,1,0,1
n1048,advance,4,3,1,2,3
n1049,whose,4,3,2,2,4
n1050,fleer1993,2,15,0,1,1
n1051,depth,4,2,1,2,3
n1052,bredekampcople1997,2,17,0,1,1
n1053,hacking1992,2,7,1,1,2
n1055,occur,4,9,0,2,2
n1056,bridge,4,1,1,2,3
n1057,current,6,1,2,1,3
n1060,ermeling2010,4,9,0,2,2
n1061,inquisitiveness,2,3,0,1,1
n1063,impact,4,11,1,2,3
n1064,let,4,11,2,2,4
n1065,seven,2,4,0,1,1
n1066,four,8,5,2,4,6
n1067,3,12,2,1,6,7
n1068,4,6,11,0,3,3
n1069,conjunction,2,1,0,1,1
n1070,multiday,2,1,1,1,2
n1071,lens,2,1,0,1,1
n1072,beyond,12,12,4,6,10
n1073,p21,2,3,0,1,1
n1074,assert,2,3,1,1,2
n1076,eickreed2002,2,14,1,1,2
n1077,bianchinicolburn2000,2,16,0,1,1
n1078,lambert2007,2,16,1,1,2
n1079,judge,6,5,0,3,3
n1080,p389,2,1,1,1,2
n1081,nrc1996,6,5,1,3,4
n1082,bodzinbeerer2003,2,5,1,1,2
n1083,rubric,2,14,0,1,1
n1084,stir,2,14,1,1,2
n1085,rate,2,1,0,1,1
n1086,six,4,5,0,2,2
n1087,prospective,2,4,0,1,1
n1088,windschitl2003,2,16,0,1,1
n1089,cookbook,2,19,0,1,1
n1090,verify,2,16,0,1,1
n1091,unknown,4,5,0,2,2
n1093,hand,10,13,3,5,8
n1094,matching,2,12,1,1,2
n1095,along,8,8,0,4,4
n1096,trundlesackes2012,2,6,1,1,2
n1097,appleton2008,4,1,0,2,2
n1098,unproductive,2,12,0,1,1
n1099,low,4,4,1,2,3
n1100,selfregulation,2,4,1,1,2
n1101,capacities,2,4,1,1,2
n1102,persistent,2,4,1,1,2
n1103,misconceptions,4,4,1,2,3
n1104,traditional,6,13,2,3,5
n1105,fail,2,8,1,1,2
n1106,restructuring,8,3,0,4,4
n1107,duittreagust2003,2,4,0,1,1
n1108,holliday2006,3,4,2,1,3
n1109,intended,6,3,1,3,4
n1110,feature,16,8,5,1,6
n1111,target,12,2,2,2,4
n1112,threestep,6,6,1,1,2
n1113,responsibility,2,1,0,1,1
n1114,sensitive,2,8,0,1,1
n1115,ensure,4,3,1,2,3
n1116,float,14,13,4,1,5
n1117,sink,11,13,1,5,6
n1118,usually,2,11,1,1,2
n1119,salient,2,8,0,1,1
n1120,weight,4,20,1,1,2
n1121,size,4,20,1,2,3
n1122,properties,6,9,0,3,3
n1123,samematerial,2,13,0,1,1
n1124,verbal,6,10,1,3,4
n1125,nonverbally,2,10,1,1,2
n1126,invitation,2,19,1,1,2
n1127,namygentner2002,2,1,0,1,1
n1128,stimulate,12,3,4,1,5
n1129,expectations,6,7,1,3,4
n1130,justify,4,16,1,2,3
n1131,bybee2006,2,2,0,1,1
n1132,molleretal2012,2,2,1,1,2
n1133,wisersmith2008,2,2,1,1,2
n1134,plastic,8,12,2,4,6
n1135,adjective,2,12,1,1,2
n1136,shininess,2,12,1,1,2
n1137,lightness,2,12,1,1,2
n1138,p209,2,12,1,1,2
n1139,grammatical,2,12,1,1,2
n1140,opposed,2,12,1,1,2
n1141,cup,2,12,1,1,2
n1142,attention,2,8,0,1,1
n1143,detect,8,6,3,4,7
n1144,appear,2,6,1,1,2
n1145,concern,10,8,1,5,6
n1146,solid,2,13,0,1,1
n1147,put,4,1,1,2,3
n1148,problemsolving,4,4,0,2,2
n1149,hmelosilver2006authentic,2,6,0,1,1
n1150,pintrich,2,12,0,1,1
n1151,marxboyle1993,2,12,1,1,2
n1152,mayerwittrock2006,2,3,0,1,1
n1153,linneylon2006,2,4,1,1,2
n1154,contextual,4,6,1,2,3
n1155,avoid,2,8,0,1,1
n1156,unable,2,12,0,1,1
n1157,fruitful,2,3,0,1,1
n1158,leave,2,3,1,1,2
n1159,organise,12,1,2,1,3
n1160,schiefelepekrun1996,2,3,1,1,2
n1161,indeed,2,14,1,1,2
n1162,selfreliant,2,14,0,1,1
n1163,hiemstra2000,2,6,0,1,1
n1164,bscs,2,14,0,1,1
n1165,motivation,6,3,1,3,4
n1166,groupconcerning,2,1,1,1,2
n1167,capability,8,8,0,4,4
n1168,coneziofrench2002,2,6,0,1,1
n1169,executive,2,6,1,1,2
n1170,garon,2,19,1,1,2
n1171,brysonsmith2008,2,19,1,1,2
n1172,operation,2,19,1,1,2
n1173,fading,2,5,0,1,1
n1174,aids,2,5,1,1,2
n1175,lepperetal1997,2,10,0,1,1
n1176,kuhn2009,2,4,0,1,1
n1177,mistakes,4,9,1,2,3
n1179,experiential,12,4,4,1,5
n1180,oversimplified,2,8,1,1,2
n1181,breunig2008,2,1,0,1,1
n1182,roberts2011,2,1,1,1,2
n1183,founders,2,4,0,1,1
n1184,belief,4,17,0,2,2
n1185,isolation,2,12,0,1,1
n1186,local,4,2,1,2,3
n1188,embraces,2,15,0,1,1
n1189,transdisciplinary,10,15,3,5,8
n1190,recreate,2,13,0,1,1
n1191,commonplace,2,12,1,1,2
n1192,reference,2,12,1,1,2
n1193,trips,2,6,0,1,1
n1194,internships,2,6,1,1,2
n1195,studentcentred,4,17,2,2,4
n1197,gordon2009,4,1,0,1,1
n1198,savery2006,7,1,3,1,4
n1199,forward,8,1,1,1,2
n1200,ontarioministryofeducation2013,4,3,0,1,1
n1201,possessing,2,16,0,1,1
n1202,capable,6,16,2,1,3
n1203,fielding2012,4,1,0,1,1
n1204,classroombased,2,17,1,1,2
n1205,knowledgepossessing,2,16,0,1,1
n1206,breunig2013,2,1,0,1,1
n1207,greifetal2006,2,9,0,1,1
n1208,hold,2,9,1,1,2
n1209,novel,2,9,0,1,1
n1210,inanimate,2,9,1,1,2
n1211,artifact,10,9,3,5,8
n1212,mobile,8,9,2,1,3
n1213,arguably,2,2,0,1,1
n1214,awareness,4,1,2,2,4
n1215,livingânonliving,2,9,1,1,2
n1216,member,4,1,0,2,2
n1217,food,2,1,1,1,2
n1218,backscheideretal1993,2,9,0,1,1
n1219,inagakihatano2002,2,9,1,1,2
n1220,keil1992,2,9,1,1,2
n1221,opfergelman2001,2,9,1,1,2
n1222,opfersiegler2004,6,9,3,3,6
n1223,correct,6,9,2,3,5
n1224,living,4,9,2,2,4
n1225,nonliving,4,9,1,2,3
n1226,immobile,4,9,1,2,3
n1227,alive,6,5,1,3,4
n1228,contrast,2,9,0,1,1
n1229,encounter,2,9,1,1,2
n1230,word,8,5,2,4,6
n1231,carey1985,2,9,1,1,2
n1232,hatanoetal1993,2,9,1,1,2
n1233,meuniercordier2004,2,9,1,1,2
n1234,richardssiegler1984,2,9,1,1,2
n1235,waxman2005,1,9,1,0,1
n1236,conceptualise,1,1,0,1,1
n1237,mediation,4,5,0,2,2
n1238,england,2,12,0,1,1
n1239,farmery2002,2,3,0,1,1
n1240,howedavies2005,2,3,1,1,2
n1241,risks,2,3,0,1,1
n1242,happen,7,7,1,3,4
n1243,schulz2012,2,3,0,1,1
n1244,exert,2,7,1,1,2
n1245,bjorklundgardiner2011p154,2,19,1,1,2
n1246,johnston2005,4,3,0,2,2
n1247,buoyancy,2,16,0,1,1
n1248,item,2,13,0,1,1
n1249,explorers,2,16,0,1,1
n1250,expect,2,3,0,1,1
n1251,keen,2,5,0,1,1
n1252,deboo2006,2,3,0,1,1
n1253,harlen2000,2,3,1,1,2
n1254,observers,2,1,0,1,1
n1255,much,4,10,0,2,2
n1256,watch,2,10,1,1,2
n1257,copying,2,10,1,1,2
n1258,everyday,8,5,2,1,3
n1259,rogoff2003,2,4,0,1,1
n1260,go,6,15,2,3,5
n1261,seeingit,2,11,1,1,2
n1262,noticing,2,16,0,1,1
n1263,sounds,2,15,0,1,1
n1264,container,2,3,0,1,1
n1265,touch,2,6,0,1,1
n1266,sound,4,5,1,2,3
n1267,quietest,2,5,0,1,1
n1268,loudest,2,5,1,1,2
n1269,sensemakingis,2,17,0,1,1
n1270,highlighted,2,17,1,1,2
n1271,eyfs,2,1,0,1,1
n1272,viewis,2,1,0,1,1
n1273,enquiring,2,1,0,1,1
n1274,minds,2,1,1,1,2
n1275,whilst,4,14,0,2,2
n1276,kallery2004,2,3,0,1,1
n1277,caveat,2,3,1,1,2
n1278,bruner,2,2,1,1,2
n1279,conceptualised,2,2,1,1,2
n1280,memorise,2,2,1,1,2
n1281,bruner1966p72,2,2,0,1,1
n1282,questionableharlen2000and,2,4,0,1,1
n1283,blakehowitt2012,2,5,0,1,1
n1284,harlen1999,2,5,1,1,2
n1285,johnston2009,2,5,1,1,2
n1286,howe,4,5,1,1,2
n1287,davies2005,4,5,1,2,3
n1288,black,2,3,0,1,1
n1289,hughes2003,2,3,1,1,2
n1290,lemke2001,2,3,1,1,2
n1291,concur,2,3,1,1,2
n1292,stress,2,3,1,1,2
n1293,contextualised,2,13,0,1,1
n1294,bound,2,13,1,1,2
n1295,socially,2,13,0,1,1
n1296,people,2,8,0,1,1
n1297,required,2,3,0,1,1
n1298,mediate,4,3,2,1,3
n1299,resonates,2,1,0,1,1
n1300,vygotskian,2,1,1,1,2
n1301,sociocultural,6,1,2,3,5
n1302,moreable,2,9,1,1,2
n1303,vygotsky19781986,2,11,1,1,2
n1304,claim,18,5,4,8,12
n1305,carefully,8,7,2,1,3
n1306,practitioner,2,16,0,1,1
n1307,evenapparently,2,16,1,1,2
n1308,intentional,2,7,0,1,1
n1309,howeverthey,2,4,0,1,1
n1310,vary,2,5,0,1,1
n1311,andor,6,14,1,3,4
n1312,childinitiated,2,8,1,1,2
n1313,intervening,2,1,0,1,1
n1314,initiate,8,1,1,4,5
n1315,deliberate,2,2,0,1,1
n1316,p159,2,16,0,1,1
n1317,balance,2,16,1,1,2
n1318,intervene,4,16,1,2,3
n1319,nuanced,4,4,1,2,3
n1320,behalf,2,4,0,1,1
n1321,pedagogic,2,16,1,1,2
n1322,covers,2,1,0,1,1
n1323,train,2,16,0,1,1
n1324,address,8,16,3,4,7
n1325,strength,2,7,1,1,2
n1326,premise,4,1,1,2,3
n1327,staff,2,14,1,1,2
n1328,assist,2,2,0,1,1
n1329,primarily,2,1,0,1,1
n1330,datausing,2,1,0,1,1
n1331,computational,2,16,0,1,1
n1332,less,6,4,2,3,5
n1335,interface,2,8,1,1,2
n1336,immersion,2,1,0,1,1
n1337,strategically,2,5,0,1,1
n1338,c,4,19,1,2,3
n1339,entwining,2,19,1,1,2
n1340,toplevel,2,18,0,1,1
n1341,subgoals,3,19,1,1,2
n1342,delight,2,6,0,1,1
n1343,illstructured,2,7,0,1,1
n1344,albeit,2,16,0,1,1
n1345,top,2,10,0,1,1
n1346,assess,2,6,1,1,2
n1347,mayr1997,2,16,0,1,1
n1348,unexplained,2,3,0,1,1
n1349,irregularity,2,3,1,1,2
n1350,anomaly,2,3,1,1,2
n1351,puzzle,4,13,0,2,2
n1352,conjecture,6,6,2,3,5
n1353,thereof,1,13,1,0,1
n1354,driveretal,1,7,1,0,1
n1355,strong,14,10,4,1,5
n1356,naÃ¯ve,6,10,2,1,3
n1357,realism,6,10,1,1,2
n1358,secondary,6,7,2,3,5
n1359,manifest,4,8,0,2,2
n1360,subsequent,6,8,1,3,4
n1361,away,2,1,0,1,1
n1362,phenomenology,2,1,1,1,2
n1363,variable,2,4,0,1,1
n1364,driveretals,2,8,1,1,2
n1365,finer,2,8,1,1,2
n1366,grain,4,8,2,2,4
n1367,vestiges,2,10,1,1,2
n1368,observable,2,8,1,1,2
n1369,takenforgranted,2,13,0,1,1
n1370,p115,4,12,1,2,3
n1371,onetoone,2,14,0,1,1
n1372,factor,2,12,1,1,2
n1373,minority,2,14,0,1,1
n1374,16yearolds,2,14,1,1,2
n1375,exhibited,2,14,1,1,2
n1376,provisional,2,3,0,1,1
n1377,status,2,3,1,1,2
n1378,directly,2,5,1,1,2
n1379,coherent,2,11,0,1,1
n1380,posited,2,14,0,1,1
n1381,imagination,2,6,0,1,1
n1382,lehrerschauble2000,2,16,0,1,1
n1383,syntactic,2,14,0,1,1
n1384,analogical,2,14,1,1,2
n1385,hypotheticaldeductive,2,14,0,1,1
n1386,adequacy,2,4,0,1,1
n1387,instrument,4,16,0,2,2
n1388,policy,3,17,1,2,3
n1389,situate,4,1,2,2,4
n1390,trend,4,11,0,2,2
n1391,recent,3,5,0,2,2
n1392,osborne2014,2,14,0,1,1
n1393,osborne,2,14,1,1,2
n1394,commitment,2,2,1,1,2
n1395,reforms,2,17,1,1,2
n1396,aligned,2,3,0,1,1
n1397,adopting,2,3,0,1,1
n1398,core,4,2,1,2,3
n1399,exemplified,2,13,0,1,1
n1400,ngss,2,8,1,1,2
n1401,nrc2012,4,8,1,2,3
n1402,examination,2,8,1,1,2
n1403,7,2,3,0,1,1
n1404,evidenceexplanation,2,11,1,1,2
n1405,ee,2,11,1,1,2
n1406,continuum,2,11,1,1,2
n1407,ascertain,2,14,0,1,1
n1408,duschl,4,15,1,2,3
n1409,outeach,2,11,1,1,2
n1410,se,2,11,1,1,2
n1411,transitions,2,11,1,1,2
n1412,count,4,5,2,2,4
n1413,second,10,15,4,5,9
n1414,potential,4,15,0,2,2
n1415,disconfirm,2,5,0,1,1
n1416,day,6,3,1,3,4
n1417,fiction,2,9,0,1,1
n1418,nonfiction,2,9,1,1,2
n1419,wrap,4,13,0,2,2
n1420,chart,2,16,0,1,1
n1421,sociocognitive,2,16,0,1,1
n1422,resembling,4,14,0,2,2
n1423,reconstruct,4,9,1,2,3
n1424,gottduggan1995,2,6,0,1,1
n1425,etkinavanheuvelen2007,2,6,1,1,2
n1426,blumniss1991,2,14,0,1,1
n1427,erickson1999,2,14,1,1,2
n1428,lubienski1999,2,14,1,1,2
n1429,constantinou1999,2,3,0,1,1
n1430,english2003,2,3,1,1,2
n1431,leshlehrer2003,2,3,1,1,2
n1432,loucazacharia2012,2,3,1,1,2
n1433,generic,2,15,0,1,1
n1434,cpd,2,1,1,1,2
n1435,impose,2,14,0,1,1
n1438,zechetal2000,1,12,0,1,1
n1439,originated,2,18,0,1,1
n1440,enough,6,7,2,3,5
n1441,slp,5,12,2,3,5
n1442,panel,2,1,0,1,1
n1443,experts,2,1,1,1,2
n1444,grandy2008these,2,15,1,1,2
n1445,validation,2,14,0,1,1
n1446,norm,12,1,3,1,4
n1447,scholars,2,1,0,1,1
n1448,regulation,2,1,0,1,1
n1449,posit,2,1,0,1,1
n1450,unique,2,13,0,1,1
n1451,chinnsamarapungavan2008,2,12,0,1,1
n1452,suppes19601962,2,12,1,1,2
n1453,woodward1989,2,12,1,1,2
n1454,vocabulary,6,8,1,3,4
n1455,laws,2,13,1,1,2
n1456,ongoing,4,15,1,2,3
n1457,utility,2,8,0,1,1
n1458,history,2,8,1,1,2
n1459,philosophy,4,1,1,2,3
n1460,cartwright19831999,2,14,0,1,1
n1461,giere1988kuhn1962,2,14,1,1,2
n1462,laudan1990,2,14,1,1,2
n1463,publications,2,12,0,1,1
n1464,spaces,2,13,0,1,1
n1465,conventions,2,13,1,1,2
n1466,criterion,4,11,1,2,3
n1468,preinquiry,2,7,0,1,1
n1469,post,1,1,0,1,1
n1470,presentations,2,10,0,1,1
n1471,limitations,2,3,0,1,1
n1472,empowering,2,3,1,1,2
n1473,zhangetal2011,2,9,1,1,2
n1474,indicators,2,16,1,1,2
n1475,reveal,6,16,2,3,5
n1476,parents,4,19,0,2,2
n1477,participated,2,1,0,1,1
n1478,eshach2011p442,2,2,1,1,2
n1479,administered,2,9,1,1,2
n1480,invention,2,3,0,1,1
n1481,intervention,2,3,1,1,2
n1482,scores,2,3,0,1,1
n1483,respect,6,11,1,3,4
n1484,wondering,2,5,0,1,1
n1485,provoked,2,14,0,1,1
n1486,human,6,1,2,3,5
n1487,beings,2,6,1,1,2
n1488,desire,2,1,0,1,1
n1489,harlanrivkin2008p4,2,17,1,1,2
n1490,barell2008,2,17,1,1,2
n1491,born,2,14,0,1,1
n1492,foster,2,3,0,1,1
n1493,keep,6,3,1,1,2
n1494,wonder,2,2,0,1,1
n1495,journal,2,2,1,1,2
n1496,problematic,4,18,0,2,2
n1497,scenarios,6,18,2,3,5
n1498,garnering,2,18,1,1,2
n1499,parental,2,18,1,1,2
n1500,rankin2011,2,8,1,1,2
n1501,sustained,2,14,0,1,1
n1502,bentleyetal2007,2,15,0,1,1
n1503,martinetal2009,4,15,1,2,3
n1504,aware,4,4,1,2,3
n1505,nowadays,2,3,0,1,1
n1506,endeavor,2,2,1,1,2
n1507,nation,4,10,2,1,3
n1508,obvious,2,3,0,1,1
n1509,endeavors,2,3,1,1,2
n1510,1981,2,3,1,1,2
n1511,commission,4,3,2,2,4
n1512,quality,6,4,1,3,4
n1513,almost,2,1,0,1,1
n1514,released,2,3,1,1,2
n1515,named,2,10,0,1,1
n1516,imperative,2,10,1,1,2
n1517,reform,2,9,0,1,1
n1518,courses,2,4,0,1,1
n1519,citizens,4,6,2,2,4
n1520,anationatrisk1983,2,18,1,1,2
n1521,2000s,2,10,0,1,1
n1522,effort,4,18,0,2,2
n1523,turkey,2,14,0,1,1
n1524,parallel,2,13,0,1,1
n1525,bulut2007,2,4,1,1,2
n1526,bahar2006,2,6,1,1,2
n1527,clues,2,16,1,1,2
n1528,extent,2,9,0,1,1
n1529,turkish,2,9,1,1,2
n1530,dialectical,4,12,2,2,4
n1531,interactants,2,20,1,1,2
n1532,dialoaic,2,6,1,1,2
n1533,ash2004,3,18,1,1,2
n1534,gallas1995,2,12,1,1,2
n1535,lemke1990,2,12,1,1,2
n1536,depict,4,1,1,2,3
n1537,engestrommiettinen1999p9,2,1,0,1,1
n1538,pertain,2,1,0,1,1
n1539,pouring,2,15,1,1,2
n1540,volume,2,1,0,1,1
n1541,feeds,2,3,0,1,1
n1542,goalâorient,2,1,0,1,1
n1543,standardized,4,8,2,2,4
n1544,ore,2,8,1,1,2
n1545,stablished,2,8,1,1,2
n1546,contrary,2,7,1,1,2
n1547,precede,2,8,1,1,2
n1548,origin,2,8,1,1,2
n1549,canonical,2,8,1,1,2
n1550,schliebenlange1987,2,19,1,1,2
n1551,institutional,2,7,0,1,1
n1552,rooted,2,12,1,1,2
n1553,configuring,2,14,0,1,1
n1554,pekarekdoehlerziegler2007p85,2,13,0,1,1
n1555,consequently,2,7,1,1,2
n1556,informal,2,2,1,1,2
n1557,unfolding,2,6,0,1,1
n1558,energy,3,13,0,1,1
n1559,lijnse1990,2,13,1,1,2
n1560,trumper1990,2,13,1,1,2
n1561,vanhooketal2005,2,12,0,1,1
n1562,vanhookhuziakclark2007b,2,12,1,1,2
n1563,air,2,4,0,1,1
n1564,magnetism,2,4,1,1,2
n1565,succinct,2,20,0,1,1
n1566,phrase,6,20,2,3,5
n1567,hooks,6,18,1,3,4
n1568,capture,4,1,2,1,3
n1569,multisensory,4,7,1,1,2
n1570,ripe,9,14,1,1,2
n1571,aid,2,12,0,1,1
n1572,abstract,2,2,1,1,2
n1573,kinesthetic,2,12,0,1,1
n1574,song,2,1,0,1,1
n1575,remember,2,15,0,1,1
n1576,intensely,2,2,0,1,1
n1577,brief,2,20,1,1,2
n1578,lift,2,18,1,1,2
n1579,squeeze,2,18,1,1,2
n1580,stretch,2,18,1,1,2
n1581,twist,2,18,1,1,2
n1582,devolve,2,2,0,1,1
n1583,lecture,2,2,1,1,2
n1584,flourish,2,3,0,1,1
n1585,helmkatz2011,5,16,1,2,3
n1586,ideally,2,16,1,1,2
n1587,due,2,4,1,1,2
n1588,constraints,2,7,1,1,2
n1589,mini,2,7,1,1,2
n1590,rain,13,5,6,6,12
n1591,weather,4,5,2,2,4
n1592,extracted,2,13,1,1,2
n1593,afterwards,2,3,1,1,2
n1594,returned,2,13,1,1,2
n1595,indepth,2,4,1,1,2
n1596,twoweek,2,5,0,1,1
n1597,span,2,5,1,1,2
n1598,performed,2,5,0,1,1
n1599,referenced,2,7,1,1,2
n1600,showcase,2,20,1,1,2
n1601,culminating,2,7,1,1,2
n1602,experiencepeters2006,2,5,0,1,1
n1603,rop2002,2,5,0,1,1
n1604,â,8,8,0,4,4
n1605,receptive,6,4,2,1,3
n1606,outpouring,2,5,1,1,2
n1607,ambivalent,2,6,1,1,2
n1608,contradictory,2,3,0,1,1
n1609,feelings,2,3,1,1,2
n1610,honour,2,3,1,1,2
n1611,struggle,2,1,0,1,1
n1612,weighed,2,8,1,1,2
n1613,seemingly,2,8,1,1,2
n1614,incompatible,2,8,1,1,2
n1615,maximize,2,4,1,1,2
n1616,cover,2,7,1,1,2
n1617,compassionate,2,4,1,1,2
n1618,annoying,2,8,0,1,1
n1619,going,2,8,1,1,2
n1620,impediment,2,8,1,1,2
n1621,overbearing,2,8,1,1,2
n1622,patience,4,2,2,2,4
n1623,arrive,2,11,1,1,2
n1624,receiving,2,16,0,1,1
n1625,common,2,16,1,1,2
n1626,wisdom,2,16,1,1,2
n1627,rapid,2,2,0,1,1
n1628,succession,2,2,1,1,2
n1629,exhorting,2,2,1,1,2
n1630,power,2,2,1,1,2
n1631,attitudes,2,11,0,1,1
n1632,discouraged,2,7,0,1,1
n1633,nursery,2,7,1,1,2
n1634,micropolitics,2,8,1,1,2
n1635,pedrosadejesusetal2012,2,1,0,1,1
n1636,occasion,4,2,1,2,3
n1637,brezillon20032005,2,2,1,1,2
n1638,intellectual,2,6,1,1,2
n1639,caudron2000p55,2,4,0,1,1
n1640,positive,2,4,1,1,2
n1641,usual,2,12,1,1,2
n1642,prime,2,11,0,1,1
n1643,arepositive,2,6,0,1,1
n1644,numerous,2,6,1,1,2
n1645,dismissed,2,11,0,1,1
n1646,welcomed,2,11,1,1,2
n1647,answerable,2,16,0,1,1
n1648,wattspedrosadejesus2006,2,16,1,1,2
n1649,mode,2,5,0,1,1
n1650,resolution,2,5,1,1,2
n1651,investigable,2,5,1,1,2
n1652,chinkayalvizhi2002,6,16,1,3,4
n1653,graessermcmahen1993,2,2,1,1,2
n1654,ingredient,4,8,1,2,3
n1655,questionasking,2,15,0,1,1
n1656,transgressive,2,15,1,1,2
n1657,third,2,16,0,1,1
n1658,tack,1,1,0,1,1
n1659,vastly,2,8,1,1,2
n1660,entailed,2,1,0,1,1
n1661,arnold2009,2,16,1,1,2
n1662,full,6,15,1,3,4
n1663,remaining,2,1,0,1,1
n1664,spring,2,5,0,1,1
n1665,odd,2,5,1,1,2
n1666,passing,2,5,1,1,2
n1667,occurrence,2,7,1,1,2
n1668,television,2,2,1,1,2
n1669,advert,2,2,1,1,2
n1670,pets,2,2,1,1,2
n1671,habits,2,2,1,1,2
n1672,sporting,2,2,0,1,1
n1673,obsessions,2,2,1,1,2
n1674,hobbies,2,2,1,1,2
n1675,disequilibrium,2,6,0,1,1
n1676,wattspedrosadejesus2010,2,3,0,1,1
n1677,clash,2,8,1,1,2
n1678,overlay,2,8,1,1,2
n1679,wattsalsop1995in,2,12,1,1,2
n1680,precurser,2,18,0,1,1
n1681,acceleration,2,1,0,1,1
n1682,dissonance,2,2,0,1,1
n1683,mccormacketal2014,2,2,1,1,2
n1684,chinkayalvizhi2005,2,2,1,1,2
n1685,thorntonbruton2015,4,2,1,2,3
n1686,earlyyears,2,9,1,1,2
n1687,reggioemilio,2,3,0,1,1
n1688,opinions,6,6,0,3,3
n1689,stands,2,4,0,1,1
n1690,paved,2,4,1,1,2
n1691,playground,2,4,1,1,2
n1692,heavy,2,4,1,1,2
n1693,spate,2,4,1,1,2
n1694,seriously,2,14,0,1,1
n1695,unafraid,2,5,0,1,1
n1696,ideas2015p17,2,9,1,1,2
n1697,intervenes,2,9,1,1,2
n1698,predetermined,2,11,1,1,2
n1699,expertise,2,7,0,1,1
n1700,p86,1,8,1,0,1
n1701,useful,2,10,0,1,1
n1702,furnished,2,8,1,1,2
n1705,positively,2,3,0,1,1
n1706,future,2,19,0,1,1
n1707,conflict,6,18,1,1,2
n1708,nrc2000,2,6,0,1,1
n1709,richards1991,2,16,0,1,1
n1710,yackeletal1990,2,5,0,1,1
n1711,participative,2,1,0,1,1
n1712,comprehend,2,7,1,1,2
n1713,heard,2,14,1,1,2
n1714,short,2,1,0,1,1
n1715,autonomy,2,8,0,1,1
n1716,firsthand,3,14,0,1,1
n1717,offers,2,4,0,1,1
n1718,abundant,2,1,0,1,1
n1719,higherlevel,2,1,1,1,2
n1720,enthusiastic,2,3,0,1,1
n1721,thinker,2,3,1,1,2
n1722,accepting,2,6,1,1,2
n1723,rationale,2,4,0,1,1
n1724,nrc1996nrc2012,2,4,1,1,2
n1725,bybee1997,2,11,0,1,1
n1726,orgillthomas2007,2,6,0,1,1
n1727,liferelated,2,6,0,1,1
n1729,error,2,1,0,1,1
n1730,attempts,2,1,1,1,2
n1731,osterman1998p4,2,16,0,1,1
n1732,past,2,7,0,1,1
n1733,requiring,2,3,0,1,1
n1734,precept,2,15,0,1,1
n1735,constructivity,2,15,0,1,1
n1736,manipulatives,2,20,0,1,1
n1737,dieness1973,2,14,1,1,2
n1738,36,2,1,1,1,2
n1739,merged,2,6,0,1,1
n1740,symbolization,2,13,1,1,2
n1741,fourstage,2,2,0,1,1
n1742,exercising,2,9,1,1,2
n1743,brain,2,9,1,1,2
n1744,executing,2,6,0,1,1
n1745,causes,2,18,0,1,1
